30 100
TCATCCCACATCGCGATTTTATCTTCAGCA|GCACGCCATATGTCATGGTCAGCGCACGGA
AAGATAATGCGCCTGTACCAGGTGCACATA|CAGCGCACGGAGTAAGGCCTACTACCCGAG
CCCTTCTAAAGCGGCTGATAGTCCGGGCGA|ACCCTGGTCAGCGCACGGAGTAAGGTCAGC
CCAGAAACGTCAGCACATAGCGACAGAAAA|TGTTCACCAGTATCACTCAGCGCTTCCATC
ATAATACCGCAGGTACTGTGTGATACCGGT|CCAATACCACTGTAGCTTACACACAAGCTT
CAGAGGTGGTCCCGGGTCAGCGCACGGAGT|CCGAGTCACACACTTTGGTTATGGGTCAGC
GACTTGGTTTCTCATCCCTATTCAAAGGTA|AGGAGCGCCACGCGGGATGCTATGACGGTG
AGGCCTACTACCCTTCGGTCAGCGCACGGA|CCTACCGAACACTTGATCATCCCACATCGC
CTTCTACGGGGGGAGCTAGTGGCTCCATTA|GGTCAGCGCACGGAGTAAGGCCTACTACCC
GATGCTATGACGGTGTCTATGTCATTAGGG|GGTCAGCGCACGGAGTAAGGCCTACTACCC
ATCTTCAGCAGCCCTGAGCCGGTACCACGG|AGCGCACGGAGTAAGGCCTACTACCCGATG
AAGAATTCGGGACGCACGCCATATGTCATG|CTACCCGGCCTACTACCCGGTTAGGAAACG
AGCTTGATTTATAGCTGGTCAGCGCACGGA|CGTCCTTTATGTACAGCAAACATATCGTCG
CTTCTAAAGCGGCTGATAGTCCGGGCGAGT|CCTGGTCAGCGCACGGAGTAAGGTCAGCGC
CAAAGGTTACGTGCCCATCAGTCACACCAT|GCACATAGCGACAGAAAAGGTTACCTACTT
GTGTCCATACAGGAGCGCCACGCGGGATGC|CCTCAAAGGAAGAGAAAGGGATAGCGGTCA
CGGACCCTTCTAAAGCGGCTGATAGTCCGG|TGTAACCCTGGTCAGCGCACGGAGTAAGGT
AGCGCACGGAGTAAGGCCTACTACCCGAGG|CCCACATCGCGATTTTATCTTCAGCAGCCC
TAGTCGACGCTATAATACCGCAGGTACTGT|TGCCTAGACCTCCAATACCACTGTAGCTTA
CCTACTACCCGGTTAGGAAACGTGTAGTCG|CGTGCCCATCAGTCACACCATGCATGCCTA
CCCCACTCCATACTAACCTCAAAGGAAGAG|GCGCGGGCTCCTAGTCGAGCAGGAAGACTT
CCCTACCGAACACTTGATCATCCCACATCG|GCGCAAGAATTCGGGACGCACGCCATATGT
GGCCTACTACCCGGCCTACTACCCGGTTAG|CTCACCAAAGGTTACGTGCCCATCAGTCAC
CTACTACCCATTCGTTAGGGGTCAATCCAG|GCGCCTGTACCAGGTGCACATATGGAAGAG
TACCCGGCTGGTCAGCGCACGGAGTAAGGC|TAAGGCCTACTACCCATTCGTTAGGGGTCA
GAGTAAGGCCTACTACCCGAAATGCCCTAC|AGTCCGGGCGAGTGAGACAAACGCGCGCAA
TACTACCCTTCGGTCAGCGCACGGAGTAAG|CGAACACTTGATCATCCCACATCGCGATTT
AATACCACTGTAGCTTACACACAAGCTTGA|CGCTTAAACTCTCCGGTAGAACCCGTCCTT
GTCACACCATGCATGCCTAGACCTCCAATA|TTACCTACTTCAATTGTGATAGCAAACGCT
CGCACGGAGTAAGGCCTACTACCCCTTCCA|TATCGTCGTACGAGATAATCACGCAATTGT
GCTATAATACCGCAGGTACTGTGTGATACC|CCTCCAATACCACTGTAGCTTACACACAAG
GTGGCTCCATTAGGGTCAGCGCACGGAGTA|GGCCTACTACCCGTCAGCGCACGGAGTAAG
AGTGAGACAAACGCGCGCAAGAATTCGGGA|CGCACGGAGTAAGGCCTACTACCCGGCCTA
CGGAGTAAGGCCTACTACCCTTCGGTCAGC|GAAATGCCCTACCGAACACTTGATCATCCC
CCCGAGGAAACTCTCGAGGAGCAAGTTCCG|GCAGCCCTGAGCCGGTACCACGGCCGAGCT
ACTACCCTTCGGTCAGCGCACGGAGTAAGG|GAACACTTGATCATCCCACATCGCGATTTT
ATTGAAAGCTGTTCGGTGGTCATGGCCGAC|CAGCGCACGGAGTAAGGCCTACTACCCCAC
GCACGGAGTAAGGCCTACTACCCGAAATGC|CTGATAGTCCGGGCGAGTGAGACAAACGCG
CAGCGCACGGAGTAAGGCCTACTACCCGGC|TGGAAGAAGTCATGGCTCACCAAAGGTTAC
AAGCGGCTGATAGTCCGGGCGAGTGAGACA|CAGCGCACGGAGTAAGGTCAGCGCACGGAG
CGGGTCAGCGCACGGAGTAAGGCCTACTAC|CTTTGGTTATGGGTCAGCGCACGGAGTAAG
GGACGGATTGATTCTCAGACGTTATTACAC|TGGTCATGGCCGACGTTTAACCGAGTGTCC
TCTACGGGGGGAGCTAGTGGCTCCATTAGG|TCAGCGCACGGAGTAAGGCCTACTACCCGT
GAGTAAGGCCTACTACCCGGAAAGAGCTGG|CTGGTCAGCGCACGGAGTAAGGCCTACTAC
GTTCGGCAGAGGTGGTCCCGGGTCAGCGCA|CAAGTTCCGAGTCACACACTTTGGTTATGG
GGGTCAGCGCACGGAGTAAGGCCTACTACC|CCCGCTGGGGAGGTCAGCGCACGGAGTAAG
CGGAGTAAGGCCTACTACCCCCTCAAGATA|GAGTAAGGCCTACTACCCTTCGGTCAGCGC
ATAATGCGCCTGTACCAGGTGCACATATGG|CGCACGGAGTAAGGCCTACTACCCGAGGAA
CATACTAACCTCAAAGGAAGAGAAAGGGAT|TCCTAGTCGAGCAGGAAGACTTCTACGGGG
TTACGTGCCCATCAGTCACACCATGCATGC|AGCGACAGAAAAGGTTACCTACTTCAATTG
TCCATACAGGAGCGCCACGCGGGATGCTAT|CAAAGGAAGAGAAAGGGATAGCGGTCAGCG
TGCATCTAGCTCGAATTTTGTAACCCTGGT|TGTGATACCGGTCAGCGCACGGAGTAAGGC
AATCCAGGCGCGGGCTCCTAGTCGAGCAGG|GGAAGAGCACAGTTGTTCGGCAGAGGTGGT
AGCGCACGGAGTAAGGCCTACTACCCATAC|GGTCAGCGCACGGAGTAAGGCCTACTACCC
TGTAACCCTGGTCAGCGCACGGAGTAAGGT|ACGGAGTAAGGCCTACTACCCGGAAAGAGC
TACACTCGTGACTTGGTTTCTCATCCCTAT|TGTCCATACAGGAGCGCCACGCGGGATGCT
AAGGCCTACTACCCCTTCCAGAAACGTCAG|CGAGATAATCACGCAATTGTTCACCAGTAT
GTCCCGGGTCAGCGCACGGAGTAAGGCCTA|CACACTTTGGTTATGGGTCAGCGCACGGAG
AAGGTCGGTCAGCGCACGGAGTAAGGCCTA|ATGTCATTAGGGTCAGCGCACGGAGTAAGG
CCATACTAACCTCAAAGGAAGAGAAAGGGA|CTCCTAGTCGAGCAGGAAGACTTCTACGGG
GGAAGAGCACAGTTGTTCGGCAGAGGTGGT|AAACTCTCGAGGAGCAAGTTCCGAGTCACA
ACGCGGGATGCTATGACGGTGTCTATGTCA|GATAGCGGTCAGCGCACGGAGTAAGGCCTA
CGGTTAGGAAACGTGTAGTCGACGCTATAA|CAGTCACACCATGCATGCCTAGACCTCCAA
CCCCCTCAAGATAATGCGCCTGTACCAGGT|CTTCGGTCAGCGCACGGAGTAAGGCCTACT
CTGTCGGACCCTTCTAAAGCGGCTGATAGT|ATTTTGTAACCCTGGTCAGCGCACGGAGTA
GTTGTTCGGCAGAGGTGGTCCCGGGTCAGC|GAGCAAGTTCCGAGTCACACACTTTGGTTA
AAGCTTGATTTATAGCTGGTCAGCGCACGG|CCGTCCTTTATGTACAGCAAACATATCGTC
AATTGAAAGCTGTTCGGTGGTCATGGCCGA|TCAGCGCACGGAGTAAGGCCTACTACCCCA
CTAGCTCGAATTTTGTAACCCTGGTCAGCG|TACCGGTCAGCGCACGGAGTAAGGCCTACT
ACCATGCATGCCTAGACCTCCAATACCACT|TACTTCAATTGTGATAGCAAACGCTTAAAC
CTCCATTAGGGTCAGCGCACGGAGTAAGGC|TACTACCCGTCAGCGCACGGAGTAAGGCCT
GGTCAGCGCACGGAGTAAGGCCTACTACCC|AGCTGGAAGAAGTCATGGCTCACCAAAGGT
ACTTTGGTTATGGGTCAGCGCACGGAGTAA|TCGGACCCTTCTAAAGCGGCTGATAGTCCG
TGCATGCCTAGACCTCCAATACCACTGTAG|TCAATTGTGATAGCAAACGCTTAAACTCTC
TCGCGATTTTATCTTCAGCAGCCCTGAGCC|TGTCATGGTCAGCGCACGGAGTAAGGCCTA
CCTACTACCCCTTCCAGAAACGTCAGCACA|ATAATCACGCAATTGTTCACCAGTATCACT
GTCAGCGCACGGAGTAAGGCCTACTACCCG|GCTGGAAGAAGTCATGGCTCACCAAAGGTT
TAAGGCCTACTACCCGAAATGCCCTACCGA|CCGGGCGAGTGAGACAAACGCGCGCAAGAA
TTCTTAGGGACGGATTGATTCTCAGACGTT|TGTTCGGTGGTCATGGCCGACGTTTAACCG
AGCAGCCCTGAGCCGGTACCACGGCCGAGC|CGGAGTAAGGCCTACTACCCGATGCATCTA
GCACGGAGTAAGGCCTACTACCCCCTCAAG|ACGGAGTAAGGCCTACTACCCTTCGGTCAG
GAGTAAGGCCTACTACCCATTCGTTAGGGG|CAAGATAATGCGCCTGTACCAGGTGCACAT
CCCGTGAATTGAAAGCTGTTCGGTGGTCAT|GGCTGGTCAGCGCACGGAGTAAGGCCTACT
TACAGGAGCGCCACGCGGGATGCTATGACG|GGAAGAGAAAGGGATAGCGGTCAGCGCACG
GGCGCGGGCTCCTAGTCGAGCAGGAAGACT|GCACAGTTGTTCGGCAGAGGTGGTCCCGGG
CAAGCTTGATTTATAGCTGGTCAGCGCACG|CCCGTCCTTTATGTACAGCAAACATATCGT
ATTTATAGCTGGTCAGCGCACGGAGTAAGG|TTATGTACAGCAAACATATCGTCGTACGAG
TCTTAGGGACGGATTGATTCTCAGACGTTA|GTTCGGTGGTCATGGCCGACGTTTAACCGA
ACGGATTGATTCTCAGACGTTATTACACTC|GTCATGGCCGACGTTTAACCGAGTGTCCAT
GCTGGTCAGCGCACGGAGTAAGGCCTACTA|CTACTACCCATTCGTTAGGGGTCAATCCAG
TACTGTGTGATACCGGTCAGCGCACGGAGT|AGCTTACACACAAGCTTGATTTATAGCTGG
CGCGCAAGAATTCGGGACGCACGCCATATG|GCCTACTACCCGGCCTACTACCCGGTTAGG
GTCAGCGCACGGAGTAAGGCCTACTACCCG|CGCTGGGGAGGTCAGCGCACGGAGTAAGGC
TAAGGCCTACTACCCGGCCTACTACCCGGT|TGGCTCACCAAAGGTTACGTGCCCATCAGT
ACCTCCAATACCACTGTAGCTTACACACAA|AGCAAACGCTTAAACTCTCCGGTAGAACCC
AGAGCTGGAAGAAGTCATGGCTCACCAAAG|CCTACTACCCCTTCCAGAAACGTCAGCACA
ATAGTCCGGGCGAGTGAGACAAACGCGCGC|GAGTAAGGTCAGCGCACGGAGTAAGGCCTA
GATTGATTCTCAGACGTTATTACACTCGTG|ATGGCCGACGTTTAACCGAGTGTCCATACA
ATATGTCATGGTCAGCGCACGGAGTAAGGC|TTAGGAAACGTGTAGTCGACGCTATAATAC
CTAGTCGAGCAGGAAGACTTCTACGGGGGG|CGGCAGAGGTGGTCCCGGGTCAGCGCACGG
AATTTTGTAACCCTGGTCAGCGCACGGAGT|AGCGCACGGAGTAAGGCCTACTACCCGGAA
ATTTTCTTAGGGACGGATTGATTCTCAGAC|AGCTGTTCGGTGGTCATGGCCGACGTTTAA
ACTCGTGACTTGGTTTCTCATCCCTATTCA|CCATACAGGAGCGCCACGCGGGATGCTATG
GTTACGTGCCCATCAGTCACACCATGCATG|TAGCGACAGAAAAGGTTACCTACTTCAATT
TAATACCGCAGGTACTGTGTGATACCGGTC|CAATACCACTGTAGCTTACACACAAGCTTG
GCGCACGGAGTAAGGCCTACTACCCTTCGG|TACCCGAAATGCCCTACCGAACACTTGATC
ATTCGGGACGCACGCCATATGTCATGGTCA|CCGGCCTACTACCCGGTTAGGAAACGTGTA
TTTTGTAACCCTGGTCAGCGCACGGAGTAA|CGCACGGAGTAAGGCCTACTACCCGGAAAG
GCACGCCATATGTCATGGTCAGCGCACGGA|TACCCGGTTAGGAAACGTGTAGTCGACGCT
GTTTCTCATCCCTATTCAAAGGTACGGAAG|GCCACGCGGGATGCTATGACGGTGTCTATG
TTTGTAACCCTGGTCAGCGCACGGAGTAAG|GCACGGAGTAAGGCCTACTACCCGGAAAGA
GGAGGTCAGCGCACGGAGTAAGGCCTACTA|GGCCTACTACCCCCTCAAGATAATGCGCCT
CGGCCGGTGATTTTCTTAGGGACGGATTGA|TGAATTGAAAGCTGTTCGGTGGTCATGGCC
TAAGGTCAGCGCACGGAGTAAGGCCTACTA|AAGAGCTGGAAGAAGTCATGGCTCACCAAA
CCTACTACCCATTCGTTAGGGGTCAATCCA|TGCGCCTGTACCAGGTGCACATATGGAAGA
TCGTGACTTGGTTTCTCATCCCTATTCAAA|ATACAGGAGCGCCACGCGGGATGCTATGAC
TGTCATTAGGGTCAGCGCACGGAGTAAGGC|GCCTACTACCCGCTGGGGAGGTCAGCGCAC
GGCAGAGGTGGTCCCGGGTCAGCGCACGGA|TTCCGAGTCACACACTTTGGTTATGGGTCA
GCGGGATGCTATGACGGTGTCTATGTCATT|TAGCGGTCAGCGCACGGAGTAAGGCCTACT
TCAGCGCACGGAGTAAGGCCTACTACCCGG|CTGGAAGAAGTCATGGCTCACCAAAGGTTA
TTGATTTATAGCTGGTCAGCGCACGGAGTA|CCTTTATGTACAGCAAACATATCGTCGTAC
GCACGGAGTAAGGCCTACTACCCGGAAAGA|TATAGCTGGTCAGCGCACGGAGTAAGGCCT
CGGTGTCTATGTCATTAGGGTCAGCGCACG|CGGAGTAAGGCCTACTACCCGCTGGGGAGG
AGGGGTCAATCCAGGCGCGGGCTCCTAGTC|CACATATGGAAGAGCACAGTTGTTCGGCAG
GTCGACGCTATAATACCGCAGGTACTGTGT|CCTAGACCTCCAATACCACTGTAGCTTACA
CGGAGTAAGGCCTACTACCCGAGGAAACTC|TCGCGATTTTATCTTCAGCAGCCCTGAGCC
GCGCACGGAGTAAGGCCTACTACCCCCTCA|GCACGGAGTAAGGCCTACTACCCTTCGGTC
CCCATTCGTTAGGGGTCAATCCAGGCGCGG|GTACCAGGTGCACATATGGAAGAGCACAGT
TACCCTTCGGTCAGCGCACGGAGTAAGGCC|ACACTTGATCATCCCACATCGCGATTTTAT
ATTTCTCGGCCGGTGATTTTCTTAGGGACG|ACCCCGTGAATTGAAAGCTGTTCGGTGGTC
TGTAGCTTACACACAAGCTTGATTTATAGC|CTCTCCGGTAGAACCCGTCCTTTATGTACA
CTCCTAGTCGAGCAGGAAGACTTCTACGGG|GTTCGGCAGAGGTGGTCCCGGGTCAGCGCA
GTCGGTCAGCGCACGGAGTAAGGCCTACTA|TCATTAGGGTCAGCGCACGGAGTAAGGCCT
TTCGGGACGCACGCCATATGTCATGGTCAG|CGGCCTACTACCCGGTTAGGAAACGTGTAG
GGCCTACTACCCATTCGTTAGGGGTCAATC|AATGCGCCTGTACCAGGTGCACATATGGAA
ATTCGTTAGGGGTCAATCCAGGCGCGGGCT|CCAGGTGCACATATGGAAGAGCACAGTTGT
GTGGTCATGGCCGACGTTTAACCGAGTGTC|GGCCTACTACCCCACTCCATACTAACCTCA
AGCGCACGGAGTAAGGCCTACTACCCGGCC|GGAAGAAGTCATGGCTCACCAAAGGTTACG
TCCCGGGTCAGCGCACGGAGTAAGGCCTAC|ACACTTTGGTTATGGGTCAGCGCACGGAGT
ACTACCCGGTTAGGAAACGTGTAGTCGACG|GCCCATCAGTCACACCATGCATGCCTAGAC
GTCAGCGCACGGAGTAAGGCCTACTACCCG|TGGTTATGGGTCAGCGCACGGAGTAAGGCC
CTGGTCAGCGCACGGAGTAAGGCCTACTAC|AGCAAACATATCGTCGTACGAGATAATCAC
CAGCGCACGGAGTAAGGTCAGCGCACGGAG|CTACTACCCGGAAAGAGCTGGAAGAAGTCA
AACGTGTAGTCGACGCTATAATACCGCAGG|CATGCATGCCTAGACCTCCAATACCACTGT
ACTACCCGAAATGCCCTACCGAACACTTGA|GTGAGACAAACGCGCGCAAGAATTCGGGAC
TACGGGGGGAGCTAGTGGCTCCATTAGGGT|AGCGCACGGAGTAAGGCCTACTACCCGTCA
TCGGGACGCACGCCATATGTCATGGTCAGC|GGCCTACTACCCGGTTAGGAAACGTGTAGT
GCTCCATTAGGGTCAGCGCACGGAGTAAGG|CTACTACCCGTCAGCGCACGGAGTAAGGCC
TAGGGTCAGCGCACGGAGTAAGGCCTACTA|TACCCGCTGGGGAGGTCAGCGCACGGAGTA
CAAGATAATGCGCCTGTACCAGGTGCACAT|TCAGCGCACGGAGTAAGGCCTACTACCCGA
AGGCCTACTACCCCTTCCAGAAACGTCAGC|GAGATAATCACGCAATTGTTCACCAGTATC
CACGGAGTAAGGCCTACTACCCGGCCTACT|GAAGTCATGGCTCACCAAAGGTTACGTGCC
CCCTGGTCAGCGCACGGAGTAAGGTCAGCG|GTAAGGCCTACTACCCGGAAAGAGCTGGAA
CACAAGCTTGATTTATAGCTGGTCAGCGCA|AACCCGTCCTTTATGTACAGCAAACATATC
CCTACTACCCCACTCCATACTAACCTCAAA|AATCCAGGCGCGGGCTCCTAGTCGAGCAGG
ACTACCCGGCTGGTCAGCGCACGGAGTAAG|AGTAAGGCCTACTACCCATTCGTTAGGGGT
CGATGCATCTAGCTCGAATTTTGTAACCCT|CTGTGTGATACCGGTCAGCGCACGGAGTAA
CGCACGGAGTAAGGCCTACTACCCTTCGGT|ACCCGAAATGCCCTACCGAACACTTGATCA
ACGGAAGGTCGGTCAGCGCACGGAGTAAGG|GTCTATGTCATTAGGGTCAGCGCACGGAGT
GTCATGGTCAGCGCACGGAGTAAGGCCTAC|GAAACGTGTAGTCGACGCTATAATACCGCA
GGAAGAGAAAGGGATAGCGGTCAGCGCACG|AAGACTTCTACGGGGGGAGCTAGTGGCTCC
AGCTGGAAGAAGTCATGGCTCACCAAAGGT|TACTACCCCTTCCAGAAACGTCAGCACATA
ATCTAGCTCGAATTTTGTAACCCTGGTCAG|GATACCGGTCAGCGCACGGAGTAAGGCCTA
ACGGAGTAAGGCCTACTACCCGGCCTACTA|AAGTCATGGCTCACCAAAGGTTACGTGCCC
ACTACCCCTTCCAGAAACGTCAGCACATAG|ATCACGCAATTGTTCACCAGTATCACTCAG
AGCGCCACGCGGGATGCTATGACGGTGTCT|GAAAGGGATAGCGGTCAGCGCACGGAGTAA
CAGCGCACGGAGTAAGGCCTACTACCCGAG|TCCCACATCGCGATTTTATCTTCAGCAGCC
TTCTCGGCCGGTGATTTTCTTAGGGACGGA|CCCGTGAATTGAAAGCTGTTCGGTGGTCAT
GCAAGAATTCGGGACGCACGCCATATGTCA|TACTACCCGGCCTACTACCCGGTTAGGAAA
GAACACTTGATCATCCCACATCGCGATTTT|AATTCGGGACGCACGCCATATGTCATGGTC
GGCCTACTACCCGGTTAGGAAACGTGTAGT|TACGTGCCCATCAGTCACACCATGCATGCC
GTCAGCGCACGGAGTAAGGCCTACTACCCA|TACTACCCCCTCAAGATAATGCGCCTGTAC
CTCCATACTAACCTCAAAGGAAGAGAAAGG|GGCTCCTAGTCGAGCAGGAAGACTTCTACG
CGGTCAGCGCACGGAGTAAGGCCTACTACC|ATTAGGGTCAGCGCACGGAGTAAGGCCTAC
CGTCAGCGCACGGAGTAAGGCCTACTACCC|CCTACTACCCGAAATGCCCTACCGAACACT
TAAGGCCTACTACCCGTCAGCGCACGGAGT|CGCACGGAGTAAGGCCTACTACCCGAAATG
AGCGCACGGAGTAAGGCCTACTACCCGATG|AGTCGACGCTATAATACCGCAGGTACTGTG
ACCCGAAATGCCCTACCGAACACTTGATCA|AGACAAACGCGCGCAAGAATTCGGGACGCA
GCCTACTACCCGTCAGCGCACGGAGTAAGG|CGGAGTAAGGCCTACTACCCGAAATGCCCT
AGTAAGGCCTACTACCCGAGGAAACTCTCG|CGATTTTATCTTCAGCAGCCCTGAGCCGGT
GTTCGGTGGTCATGGCCGACGTTTAACCGA|AGTAAGGCCTACTACCCCACTCCATACTAA
TCAAAGGAAGAGAAAGGGATAGCGGTCAGC|GCAGGAAGACTTCTACGGGGGGAGCTAGTG
ACGTCAGCACATAGCGACAGAAAAGGTTAC|CCAGTATCACTCAGCGCTTCCATCTACGAC
TAATGCGCCTGTACCAGGTGCACATATGGA|GCACGGAGTAAGGCCTACTACCCGAGGAAA
TTAGGAAACGTGTAGTCGACGCTATAATAC|TCACACCATGCATGCCTAGACCTCCAATAC
CTGAGCCGGTACCACGGCCGAGCTCTTTCC|AGGCCTACTACCCGATGCATCTAGCTCGAA
TGCCCATCAGTCACACCATGCATGCCTAGA|CAGAAAAGGTTACCTACTTCAATTGTGATA
ATTAGGGTCAGCGCACGGAGTAAGGCCTAC|ACTACCCGCTGGGGAGGTCAGCGCACGGAG
GAGCTGGAAGAAGTCATGGCTCACCAAAGG|CTACTACCCCTTCCAGAAACGTCAGCACAT
GCCTACTACCCGATGCATCTAGCTCGAATT|ACCGCAGGTACTGTGTGATACCGGTCAGCG
AGCGCACGGAGTAAGGCCTACTACCCGCTG|GTGGCTCCATTAGGGTCAGCGCACGGAGTA
CGGTACCACGGCCGAGCTCTTTCCTGTCGG|ACTACCCGATGCATCTAGCTCGAATTTTGT
CGTGAATTGAAAGCTGTTCGGTGGTCATGG|CTGGTCAGCGCACGGAGTAAGGCCTACTAC
TACTACCCATTCGTTAGGGGTCAATCCAGG|CGCCTGTACCAGGTGCACATATGGAAGAGC
TGGTCCCGGGTCAGCGCACGGAGTAAGGCC|CACACACTTTGGTTATGGGTCAGCGCACGG
TTAGGGTCAGCGCACGGAGTAAGGCCTACT|CTACCCGCTGGGGAGGTCAGCGCACGGAGT
CATGCCTAGACCTCCAATACCACTGTAGCT|AATTGTGATAGCAAACGCTTAAACTCTCCG
CTACCCCCTCAAGATAATGCGCCTGTACCA|ACCCTTCGGTCAGCGCACGGAGTAAGGCCT
ATGGGTCAGCGCACGGAGTAAGGCCTACTA|TCTAAAGCGGCTGATAGTCCGGGCGAGTGA
CTATGTCATTAGGGTCAGCGCACGGAGTAA|AAGGCCTACTACCCGCTGGGGAGGTCAGCG
TCCTGTCGGACCCTTCTAAAGCGGCTGATA|GAATTTTGTAACCCTGGTCAGCGCACGGAG
TGATCATCCCACATCGCGATTTTATCTTCA|GACGCACGCCATATGTCATGGTCAGCGCAC
CAGCCCTGAGCCGGTACCACGGCCGAGCTC|GAGTAAGGCCTACTACCCGATGCATCTAGC
GCGATTTTATCTTCAGCAGCCCTGAGCCGG|TCATGGTCAGCGCACGGAGTAAGGCCTACT
CTACCCCACTCCATACTAACCTCAAAGGAA|CAGGCGCGGGCTCCTAGTCGAGCAGGAAGA
CGCACGGAGTAAGGCCTACTACCCGGCCTA|AAGAAGTCATGGCTCACCAAAGGTTACGTG
AAAGAGCTGGAAGAAGTCATGGCTCACCAA|GGCCTACTACCCCTTCCAGAAACGTCAGCA
CTATTTCTCGGCCGGTGATTTTCTTAGGGA|ATACCCCGTGAATTGAAAGCTGTTCGGTGG
ACGGAGTAAGGCCTACTACCCGATGCATCT|ACGCTATAATACCGCAGGTACTGTGTGATA
CGGCCTACTACCCGGTTAGGAAACGTGTAG|TTACGTGCCCATCAGTCACACCATGCATGC
GCGCACGGAGTAAGGCCTACTACCCCTTCC|ATATCGTCGTACGAGATAATCACGCAATTG
GATAATGCGCCTGTACCAGGTGCACATATG|GCGCACGGAGTAAGGCCTACTACCCGAGGA
CGGGACGCACGCCATATGTCATGGTCAGCG|GCCTACTACCCGGTTAGGAAACGTGTAGTC
AGAATTCGGGACGCACGCCATATGTCATGG|TACCCGGCCTACTACCCGGTTAGGAAACGT
GAGGTGGTCCCGGGTCAGCGCACGGAGTAA|GAGTCACACACTTTGGTTATGGGTCAGCGC
TAGCTCGAATTTTGTAACCCTGGTCAGCGC|ACCGGTCAGCGCACGGAGTAAGGCCTACTA
AAGGCCTACTACCCGCTGGGGAGGTCAGCG|GGGTCAGCGCACGGAGTAAGGCCTACTACC
TTAACCGAGTGTCCATACAGGAGCGCCACG|CATACTAACCTCAAAGGAAGAGAAAGGGAT
GTAAGGCCTACTACCCCCTCAAGATAATGC|AAGGCCTACTACCCTTCGGTCAGCGCACGG
TACTACCCGGCCTACTACCCGGTTAGGAAA|CCAAAGGTTACGTGCCCATCAGTCACACCA
CTCTTTCCTGTCGGACCCTTCTAAAGCGGC|AGCTCGAATTTTGTAACCCTGGTCAGCGCA
ACCCGATGCATCTAGCTCGAATTTTGTAAC|GTACTGTGTGATACCGGTCAGCGCACGGAG
CACGGAGTAAGGCCTACTACCCGCTGGGGA|CTCCATTAGGGTCAGCGCACGGAGTAAGGC
TACCAGGTGCACATATGGAAGAGCACAGTT|GGCCTACTACCCGAGGAAACTCTCGAGGAG
TCAAGATAATGCGCCTGTACCAGGTGCACA|GTCAGCGCACGGAGTAAGGCCTACTACCCG
GCGCACGGAGTAAGGCCTACTACCCGGCTG|GGGGAGGTCAGCGCACGGAGTAAGGCCTAC
ACAAGCTTGATTTATAGCTGGTCAGCGCAC|ACCCGTCCTTTATGTACAGCAAACATATCG
CGCGGGCTCCTAGTCGAGCAGGAAGACTTC|ACAGTTGTTCGGCAGAGGTGGTCCCGGGTC
GGAGTAAGGTCAGCGCACGGAGTAAGGCCT|CGGAAAGAGCTGGAAGAAGTCATGGCTCAC
CCGCTGGGGAGGTCAGCGCACGGAGTAAGG|GGAGTAAGGCCTACTACCCCCTCAAGATAA
CGACGCTATAATACCGCAGGTACTGTGTGA|TAGACCTCCAATACCACTGTAGCTTACACA
CTACTACCCGGAAAGAGCTGGAAGAAGTCA|GCACGGAGTAAGGCCTACTACCCCTTCCAG
GGAGCAAGTTCCGAGTCACACACTTTGGTT|CCACGGCCGAGCTCTTTCCTGTCGGACCCT
GCACGGAGTAAGGTCAGCGCACGGAGTAAG|TACCCGGAAAGAGCTGGAAGAAGTCATGGC
ATGCATCTAGCTCGAATTTTGTAACCCTGG|GTGTGATACCGGTCAGCGCACGGAGTAAGG
CAGCGCACGGAGTAAGGCCTACTACCCCAC|CCCATTCGTTAGGGGTCAATCCAGGCGCGG
CATTCGTTAGGGGTCAATCCAGGCGCGGGC|ACCAGGTGCACATATGGAAGAGCACAGTTG
TAAGGCCTACTACCCCTTCCAGAAACGTCA|ACGAGATAATCACGCAATTGTTCACCAGTA
CGCGCGCAAGAATTCGGGACGCACGCCATA|AGGCCTACTACCCGGCCTACTACCCGGTTA
ATGCCCTACCGAACACTTGATCATCCCACA|CGCGCGCAAGAATTCGGGACGCACGCCATA
ACCCTTCGGTCAGCGCACGGAGTAAGGCCT|CACTTGATCATCCCACATCGCGATTTTATC
TGGTCAGCGCACGGAGTAAGGCCTACTACC|CGTGTAGTCGACGCTATAATACCGCAGGTA
CTACTACCCGGCCTACTACCCGGTTAGGAA|ACCAAAGGTTACGTGCCCATCAGTCACACC
AAGGTACGGAAGGTCGGTCAGCGCACGGAG|ACGGTGTCTATGTCATTAGGGTCAGCGCAC
TACCCGGAAAGAGCTGGAAGAAGTCATGGC|GGAGTAAGGCCTACTACCCCTTCCAGAAAC
ACCCGGCTGGTCAGCGCACGGAGTAAGGCC|AAGGCCTACTACCCATTCGTTAGGGGTCAA
GGGGGGAGCTAGTGGCTCCATTAGGGTCAG|GCACGGAGTAAGGCCTACTACCCGTCAGCG
TAACCTCAAAGGAAGAGAAAGGGATAGCGG|GTCGAGCAGGAAGACTTCTACGGGGGGAGC
GCGCACGGAGTAAGGCCTACTACCCATTCG|ACCCCCTCAAGATAATGCGCCTGTACCAGG
CCATCAGTCACACCATGCATGCCTAGACCT|AAAAGGTTACCTACTTCAATTGTGATAGCA
CGAATTTTGTAACCCTGGTCAGCGCACGGA|TCAGCGCACGGAGTAAGGCCTACTACCCGG
TGCACATATGGAAGAGCACAGTTGTTCGGC|TACCCGAGGAAACTCTCGAGGAGCAAGTTC
TTCGGCAGAGGTGGTCCCGGGTCAGCGCAC|AAGTTCCGAGTCACACACTTTGGTTATGGG
CCGGCTGGTCAGCGCACGGAGTAAGGCCTA|GGCCTACTACCCATTCGTTAGGGGTCAATC
CTACTACCCATACCCCGTGAATTGAAAGCT|AGGCCTACTACCCGGCTGGTCAGCGCACGG
ACCCGGTTAGGAAACGTGTAGTCGACGCTA|CATCAGTCACACCATGCATGCCTAGACCTC
ATGGAAGAGCACAGTTGTTCGGCAGAGGTG|GGAAACTCTCGAGGAGCAAGTTCCGAGTCA
GGGGGAGCTAGTGGCTCCATTAGGGTCAGC|CACGGAGTAAGGCCTACTACCCGTCAGCGC
AAGGTTACGTGCCCATCAGTCACACCATGC|ACATAGCGACAGAAAAGGTTACCTACTTCA
ACCCCCTCAAGATAATGCGCCTGTACCAGG|CCTTCGGTCAGCGCACGGAGTAAGGCCTAC
CGGAGTAAGGCCTACTACCCGATGCATCTA|CGCTATAATACCGCAGGTACTGTGTGATAC
TATGACGGTGTCTATGTCATTAGGGTCAGC|GCGCACGGAGTAAGGCCTACTACCCGCTGG
CACATATGGAAGAGCACAGTTGTTCGGCAG|CCCGAGGAAACTCTCGAGGAGCAAGTTCCG
GCACGGAGTAAGGCCTACTACCCGATGCAT|CGACGCTATAATACCGCAGGTACTGTGTGA
AGGAAACTCTCGAGGAGCAAGTTCCGAGTC|CCCTGAGCCGGTACCACGGCCGAGCTCTTT
GAGTAAGGCCTACTACCCCTTCCAGAAACG|CGTACGAGATAATCACGCAATTGTTCACCA
CCAAAGGTTACGTGCCCATCAGTCACACCA|AGCACATAGCGACAGAAAAGGTTACCTACT
AGGAGCGCCACGCGGGATGCTATGACGGTG|AGAGAAAGGGATAGCGGTCAGCGCACGGAG
TGTTCGGCAGAGGTGGTCCCGGGTCAGCGC|GCAAGTTCCGAGTCACACACTTTGGTTATG
GTAAGGCCTACTACCCGATGCATCTAGCTC|ATAATACCGCAGGTACTGTGTGATACCGGT
TCGAGCAGGAAGACTTCTACGGGGGGAGCT|AGAGGTGGTCCCGGGTCAGCGCACGGAGTA
TAGGGGTCAATCCAGGCGCGGGCTCCTAGT|GCACATATGGAAGAGCACAGTTGTTCGGCA
AGAAACGTCAGCACATAGCGACAGAAAAGG|TTCACCAGTATCACTCAGCGCTTCCATCTA
TCAGTCACACCATGCATGCCTAGACCTCCA|AGGTTACCTACTTCAATTGTGATAGCAAAC
CGCACGGAGTAAGGCCTACTACCCGCTGGG|GGCTCCATTAGGGTCAGCGCACGGAGTAAG
CCTACTACCCGTCAGCGCACGGAGTAAGGC|GGAGTAAGGCCTACTACCCGAAATGCCCTA
CTACTACCCGGTTAGGAAACGTGTAGTCGA|GTGCCCATCAGTCACACCATGCATGCCTAG
TAAGGCCTACTACCCGCTGGGGAGGTCAGC|AGGGTCAGCGCACGGAGTAAGGCCTACTAC
GCTCGAATTTTGTAACCCTGGTCAGCGCAC|CGGTCAGCGCACGGAGTAAGGCCTACTACC
ACACTTTGGTTATGGGTCAGCGCACGGAGT|TGTCGGACCCTTCTAAAGCGGCTGATAGTC
GGGGTCAATCCAGGCGCGGGCTCCTAGTCG|ACATATGGAAGAGCACAGTTGTTCGGCAGA
GGAAACGTGTAGTCGACGCTATAATACCGC|CACCATGCATGCCTAGACCTCCAATACCAC
TCAAAGGTACGGAAGGTCGGTCAGCGCACG|ATGACGGTGTCTATGTCATTAGGGTCAGCG
CTTCGGTCAGCGCACGGAGTAAGGCCTACT|TTGATCATCCCACATCGCGATTTTATCTTC
GTGTAGTCGACGCTATAATACCGCAGGTAC|GCATGCCTAGACCTCCAATACCACTGTAGC
AGTAAGGCCTACTACCCCCTCAAGATAATG|TAAGGCCTACTACCCTTCGGTCAGCGCACG
CACCATGCATGCCTAGACCTCCAATACCAC|CTACTTCAATTGTGATAGCAAACGCTTAAA
GCCACGCGGGATGCTATGACGGTGTCTATG|AGGGATAGCGGTCAGCGCACGGAGTAAGGC
GACAAACGCGCGCAAGAATTCGGGACGCAC|GGAGTAAGGCCTACTACCCGGCCTACTACC
AAGGCCTACTACCCATTCGTTAGGGGTCAA|ATAATGCGCCTGTACCAGGTGCACATATGG
GGTCGGTCAGCGCACGGAGTAAGGCCTACT|GTCATTAGGGTCAGCGCACGGAGTAAGGCC
ACAAACGCGCGCAAGAATTCGGGACGCACG|GAGTAAGGCCTACTACCCGGCCTACTACCC
GCAAGTTCCGAGTCACACACTTTGGTTATG|CGGCCGAGCTCTTTCCTGTCGGACCCTTCT
GTAAGGCCTACTACCCGGAAAGAGCTGGAA|GGTCAGCGCACGGAGTAAGGCCTACTACCC
TATTTCTCGGCCGGTGATTTTCTTAGGGAC|TACCCCGTGAATTGAAAGCTGTTCGGTGGT
GGCCTACTACCCTTCGGTCAGCGCACGGAG|CTACCGAACACTTGATCATCCCACATCGCG
CTACTACCCGAAATGCCCTACCGAACACTT|GAGTGAGACAAACGCGCGCAAGAATTCGGG
TAAAGCTAGGGTCTATTTCTCGGCCGGTGA|GGCCTACTACCCATACCCCGTGAATTGAAA
TTCGTTAGGGGTCAATCCAGGCGCGGGCTC|CAGGTGCACATATGGAAGAGCACAGTTGTT
TGCTATGACGGTGTCTATGTCATTAGGGTC|TCAGCGCACGGAGTAAGGCCTACTACCCGC
TGACGGTGTCTATGTCATTAGGGTCAGCGC|GCACGGAGTAAGGCCTACTACCCGCTGGGG
GGTCAGCGCACGGAGTAAGGCCTACTACCC|TCAGCGCACGGAGTAAGGCCTACTACCCTT
CCCCTTCCAGAAACGTCAGCACATAGCGAC|CGCAATTGTTCACCAGTATCACTCAGCGCT
GACGCACGCCATATGTCATGGTCAGCGCAC|TACTACCCGGTTAGGAAACGTGTAGTCGAC
GAGTAAGGCCTACTACCCCCTCAAGATAAT|GTAAGGCCTACTACCCTTCGGTCAGCGCAC
CTTAGGGACGGATTGATTCTCAGACGTTAT|TTCGGTGGTCATGGCCGACGTTTAACCGAG
CACATCGCGATTTTATCTTCAGCAGCCCTG|CATATGTCATGGTCAGCGCACGGAGTAAGG
GAGGTCAGCGCACGGAGTAAGGCCTACTAC|GCCTACTACCCCCTCAAGATAATGCGCCTG
GGTGATTTTCTTAGGGACGGATTGATTCTC|TGAAAGCTGTTCGGTGGTCATGGCCGACGT
GAATTTTGTAACCCTGGTCAGCGCACGGAG|CAGCGCACGGAGTAAGGCCTACTACCCGGA
AAGGCCTACTACCCGAGGAAACTCTCGAGG|TTTTATCTTCAGCAGCCCTGAGCCGGTACC
GCTGGGGAGGTCAGCGCACGGAGTAAGGCC|AGTAAGGCCTACTACCCCCTCAAGATAATG
CACGGAGTAAGGCCTACTACCCATACCCCG|AGCGCACGGAGTAAGGCCTACTACCCGGCT
CGGTCAGCGCACGGAGTAAGGCCTACTACC|ATCATCCCACATCGCGATTTTATCTTCAGC
AGGAAGACTTCTACGGGGGGAGCTAGTGGC|GGTCCCGGGTCAGCGCACGGAGTAAGGCCT
ATCGCGATTTTATCTTCAGCAGCCCTGAGC|ATGTCATGGTCAGCGCACGGAGTAAGGCCT
ACCCATACCCCGTGAATTGAAAGCTGTTCG|TACTACCCGGCTGGTCAGCGCACGGAGTAA
GAGGAAACTCTCGAGGAGCAAGTTCCGAGT|GCCCTGAGCCGGTACCACGGCCGAGCTCTT
ATAGCTGGTCAGCGCACGGAGTAAGGCCTA|GTACAGCAAACATATCGTCGTACGAGATAA
CGCCACGCGGGATGCTATGACGGTGTCTAT|AAGGGATAGCGGTCAGCGCACGGAGTAAGG
GCCTACTACCCATTCGTTAGGGGTCAATCC|ATGCGCCTGTACCAGGTGCACATATGGAAG
GCGCACGGAGTAAGGCCTACTACCCGAGGA|CCACATCGCGATTTTATCTTCAGCAGCCCT
ACGGAGTAAGGCCTACTACCCCCTCAAGAT|GGAGTAAGGCCTACTACCCTTCGGTCAGCG
GCCTACTACCCGAGGAAACTCTCGAGGAGC|TATCTTCAGCAGCCCTGAGCCGGTACCACG
AAGGGATAGCGGTCAGCGCACGGAGTAAGG|TACGGGGGGAGCTAGTGGCTCCATTAGGGT
AGGCGCGGGCTCCTAGTCGAGCAGGAAGAC|AGCACAGTTGTTCGGCAGAGGTGGTCCCGG
GCCTACTACCCCACTCCATACTAACCTCAA|CAATCCAGGCGCGGGCTCCTAGTCGAGCAG
GTCAGCGCACGGAGTAAGGCCTACTACCCT|CTACTACCCGAAATGCCCTACCGAACACTT
GCGCACGGAGTAAGGCCTACTACCCGGAAA|TTTATAGCTGGTCAGCGCACGGAGTAAGGC
ACGGCCGAGCTCTTTCCTGTCGGACCCTTC|GATGCATCTAGCTCGAATTTTGTAACCCTG
CTACCCGGCTGGTCAGCGCACGGAGTAAGG|GTAAGGCCTACTACCCATTCGTTAGGGGTC
GAGTAAGGCCTACTACCCGATGCATCTAGC|CTATAATACCGCAGGTACTGTGTGATACCG
ACGGAGTAAGGCCTACTACCCGTCAGCGCA|GGTCAGCGCACGGAGTAAGGCCTACTACCC
GAGCTAGTGGCTCCATTAGGGTCAGCGCAC|GAGTAAGGCCTACTACCCGTCAGCGCACGG
CGAGTGTCCATACAGGAGCGCCACGCGGGA|TAACCTCAAAGGAAGAGAAAGGGATAGCGG
GGCCTACTACCCGAAATGCCCTACCGAACA|GGCGAGTGAGACAAACGCGCGCAAGAATTC
GAAGAAGTCATGGCTCACCAAAGGTTACGT|CCCCTTCCAGAAACGTCAGCACATAGCGAC
TCGGTGGTCATGGCCGACGTTTAACCGAGT|TAAGGCCTACTACCCCACTCCATACTAACC
CTAGGGTCTATTTCTCGGCCGGTGATTTTC|ACTACCCATACCCCGTGAATTGAAAGCTGT
AAGGCCTACTACCCCCTCAAGATAATGCGC|GGCCTACTACCCTTCGGTCAGCGCACGGAG
GCGCCACGCGGGATGCTATGACGGTGTCTA|AAAGGGATAGCGGTCAGCGCACGGAGTAAG
CGCACGGAGTAAGGTCAGCGCACGGAGTAA|CTACCCGGAAAGAGCTGGAAGAAGTCATGG
TACCGGTCAGCGCACGGAGTAAGGCCTACT|CAAGCTTGATTTATAGCTGGTCAGCGCACG
GTCAGCGCACGGAGTAAGGCCTACTACCCA|TAGGGTCAGCGCACGGAGTAAGGCCTACTA
TGATAGTCCGGGCGAGTGAGACAAACGCGC|CGGAGTAAGGTCAGCGCACGGAGTAAGGCC
AGGCCTACTACCCGAAATGCCCTACCGAAC|GGGCGAGTGAGACAAACGCGCGCAAGAATT
ACATCGCGATTTTATCTTCAGCAGCCCTGA|ATATGTCATGGTCAGCGCACGGAGTAAGGC
GTGAGACAAACGCGCGCAAGAATTCGGGAC|GCACGGAGTAAGGCCTACTACCCGGCCTAC
AGCAAGTTCCGAGTCACACACTTTGGTTAT|ACGGCCGAGCTCTTTCCTGTCGGACCCTTC
GCCCATCAGTCACACCATGCATGCCTAGAC|AGAAAAGGTTACCTACTTCAATTGTGATAG
TTTAACCGAGTGTCCATACAGGAGCGCCAC|CCATACTAACCTCAAAGGAAGAGAAAGGGA
CCTACTACCCCCTCAAGATAATGCGCCTGT|TACTACCCTTCGGTCAGCGCACGGAGTAAG
GCTGGAAGAAGTCATGGCTCACCAAAGGTT|ACTACCCCTTCCAGAAACGTCAGCACATAG
TACTAACCTCAAAGGAAGAGAAAGGGATAG|CTAGTCGAGCAGGAAGACTTCTACGGGGGG
CGGGCTCCTAGTCGAGCAGGAAGACTTCTA|AGTTGTTCGGCAGAGGTGGTCCCGGGTCAG
GAAATGCCCTACCGAACACTTGATCATCCC|AAACGCGCGCAAGAATTCGGGACGCACGCC
ATATGGAAGAGCACAGTTGTTCGGCAGAGG|GAGGAAACTCTCGAGGAGCAAGTTCCGAGT
CTACCCCTTCCAGAAACGTCAGCACATAGC|TCACGCAATTGTTCACCAGTATCACTCAGC
GATAGCGGTCAGCGCACGGAGTAAGGCCTA|GGGGGAGCTAGTGGCTCCATTAGGGTCAGC
ACCGAGTGTCCATACAGGAGCGCCACGCGG|ACTAACCTCAAAGGAAGAGAAAGGGATAGC
CATCGCGATTTTATCTTCAGCAGCCCTGAG|TATGTCATGGTCAGCGCACGGAGTAAGGCC
AGCTCGAATTTTGTAACCCTGGTCAGCGCA|CCGGTCAGCGCACGGAGTAAGGCCTACTAC
GCTAGGGTCTATTTCTCGGCCGGTGATTTT|TACTACCCATACCCCGTGAATTGAAAGCTG
CGCCTGTACCAGGTGCACATATGGAAGAGC|GAGTAAGGCCTACTACCCGAGGAAACTCTC
TAAGGCCTACTACCCGAGGAAACTCTCGAG|ATTTTATCTTCAGCAGCCCTGAGCCGGTAC
GCAGGAAGACTTCTACGGGGGGAGCTAGTG|GTGGTCCCGGGTCAGCGCACGGAGTAAGGC
CACGGAGTAAGGCCTACTACCCTTCGGTCA|CCGAAATGCCCTACCGAACACTTGATCATC
CACGGAGTAAGGCCTACTACCCGGAAAGAG|ATAGCTGGTCAGCGCACGGAGTAAGGCCTA
CTACCCGGTTAGGAAACGTGTAGTCGACGC|CCCATCAGTCACACCATGCATGCCTAGACC
ACGGAGTAAGGCCTACTACCCATTCGTTAG|CCTCAAGATAATGCGCCTGTACCAGGTGCA
GTTAGGAAACGTGTAGTCGACGCTATAATA|GTCACACCATGCATGCCTAGACCTCCAATA
CTGTAGCTTACACACAAGCTTGATTTATAG|ACTCTCCGGTAGAACCCGTCCTTTATGTAC
TATGGGTCAGCGCACGGAGTAAGGCCTACT|TTCTAAAGCGGCTGATAGTCCGGGCGAGTG
CTACTACCCGAGGAAACTCTCGAGGAGCAA|TCTTCAGCAGCCCTGAGCCGGTACCACGGC
GGACCCTTCTAAAGCGGCTGATAGTCCGGG|GTAACCCTGGTCAGCGCACGGAGTAAGGTC
TCTCGGCCGGTGATTTTCTTAGGGACGGAT|CCGTGAATTGAAAGCTGTTCGGTGGTCATG
TTGATTCTCAGACGTTATTACACTCGTGAC|GGCCGACGTTTAACCGAGTGTCCATACAGG
CCTACTACCCGGAAAGAGCTGGAAGAAGTC|CGCACGGAGTAAGGCCTACTACCCCTTCCA
CGCACGGAGTAAGGCCTACTACCCATTCGT|CCCCCTCAAGATAATGCGCCTGTACCAGGT
ACCAGGTGCACATATGGAAGAGCACAGTTG|GCCTACTACCCGAGGAAACTCTCGAGGAGC
TCAGCGCACGGAGTAAGGTCAGCGCACGGA|CCTACTACCCGGAAAGAGCTGGAAGAAGTC
GGTGGTCCCGGGTCAGCGCACGGAGTAAGG|GTCACACACTTTGGTTATGGGTCAGCGCAC
TACCCGAGGAAACTCTCGAGGAGCAAGTTC|CAGCAGCCCTGAGCCGGTACCACGGCCGAG
TAAAGCGGCTGATAGTCCGGGCGAGTGAGA|GTCAGCGCACGGAGTAAGGTCAGCGCACGG
GCAGCCCTGAGCCGGTACCACGGCCGAGCT|GGAGTAAGGCCTACTACCCGATGCATCTAG
ACTTCTACGGGGGGAGCTAGTGGCTCCATT|GGGTCAGCGCACGGAGTAAGGCCTACTACC
ACCCGAGGAAACTCTCGAGGAGCAAGTTCC|AGCAGCCCTGAGCCGGTACCACGGCCGAGC
CTGGTCAGCGCACGGAGTAAGGCCTACTAC|TACTACCCATTCGTTAGGGGTCAATCCAGG
CAGCGCACGGAGTAAGGCCTACTACCCATT|CTACCCCCTCAAGATAATGCGCCTGTACCA
TGTCGGACCCTTCTAAAGCGGCTGATAGTC|TTTTGTAACCCTGGTCAGCGCACGGAGTAA
CAAAGGAAGAGAAAGGGATAGCGGTCAGCG|CAGGAAGACTTCTACGGGGGGAGCTAGTGG
TTCTAAAGCGGCTGATAGTCCGGGCGAGTG|CTGGTCAGCGCACGGAGTAAGGTCAGCGCA
CCGAAATGCCCTACCGAACACTTGATCATC|ACAAACGCGCGCAAGAATTCGGGACGCACG
GCACGGAGTAAGGCCTACTACCCTTCGGTC|CCCGAAATGCCCTACCGAACACTTGATCAT
AGTAAGGCCTACTACCCGTCAGCGCACGGA|AGCGCACGGAGTAAGGCCTACTACCCGAAA
TCAGCGCACGGAGTAAGGCCTACTACCCGG|GCTGGGGAGGTCAGCGCACGGAGTAAGGCC
TCGACGCTATAATACCGCAGGTACTGTGTG|CTAGACCTCCAATACCACTGTAGCTTACAC
ACTGTGTGATACCGGTCAGCGCACGGAGTA|GCTTACACACAAGCTTGATTTATAGCTGGT
ACCCTTCTAAAGCGGCTGATAGTCCGGGCG|AACCCTGGTCAGCGCACGGAGTAAGGTCAG
TTCGGTCAGCGCACGGAGTAAGGCCTACTA|TGATCATCCCACATCGCGATTTTATCTTCA
CCGGGTCAGCGCACGGAGTAAGGCCTACTA|ACTTTGGTTATGGGTCAGCGCACGGAGTAA
ACCGAACACTTGATCATCCCACATCGCGAT|AAGAATTCGGGACGCACGCCATATGTCATG
AGCGGCTGATAGTCCGGGCGAGTGAGACAA|AGCGCACGGAGTAAGGTCAGCGCACGGAGT
TGATTTATAGCTGGTCAGCGCACGGAGTAA|CTTTATGTACAGCAAACATATCGTCGTACG
GTGTGATACCGGTCAGCGCACGGAGTAAGG|TACACACAAGCTTGATTTATAGCTGGTCAG
TCCCTATTCAAAGGTACGGAAGGTCGGTCA|GGATGCTATGACGGTGTCTATGTCATTAGG
GCTGGTCAGCGCACGGAGTAAGGCCTACTA|CAGCAAACATATCGTCGTACGAGATAATCA
CGCAGGTACTGTGTGATACCGGTCAGCGCA|CACTGTAGCTTACACACAAGCTTGATTTAT
GTCACACACTTTGGTTATGGGTCAGCGCAC|TTTCCTGTCGGACCCTTCTAAAGCGGCTGA
GGATAGCGGTCAGCGCACGGAGTAAGGCCT|GGGGGGAGCTAGTGGCTCCATTAGGGTCAG
GCTGATAGTCCGGGCGAGTGAGACAAACGC|CACGGAGTAAGGTCAGCGCACGGAGTAAGG
GTTAGGGGTCAATCCAGGCGCGGGCTCCTA|GTGCACATATGGAAGAGCACAGTTGTTCGG
GGTCAGCGCACGGAGTAAGGCCTACTACCC|GCTAGTGGCTCCATTAGGGTCAGCGCACGG
GATTTTATCTTCAGCAGCCCTGAGCCGGTA|ATGGTCAGCGCACGGAGTAAGGCCTACTAC
CTTGATTTATAGCTGGTCAGCGCACGGAGT|TCCTTTATGTACAGCAAACATATCGTCGTA
CTCAAGATAATGCGCCTGTACCAGGTGCAC|GGTCAGCGCACGGAGTAAGGCCTACTACCC
CAGCGCACGGAGTAAGGCCTACTACCCTTC|ACTACCCGAAATGCCCTACCGAACACTTGA
CCTACTACCCGAGGAAACTCTCGAGGAGCA|ATCTTCAGCAGCCCTGAGCCGGTACCACGG
TCGGTCAGCGCACGGAGTAAGGCCTACTAC|GATCATCCCACATCGCGATTTTATCTTCAG
TCAGCGCACGGAGTAAGGCCTACTACCCGC|TAGTGGCTCCATTAGGGTCAGCGCACGGAG
GCCTACTACCCGCTGGGGAGGTCAGCGCAC|TCAGCGCACGGAGTAAGGCCTACTACCCCC
GATTTTCTTAGGGACGGATTGATTCTCAGA|AAGCTGTTCGGTGGTCATGGCCGACGTTTA
CCCGATGCATCTAGCTCGAATTTTGTAACC|TACTGTGTGATACCGGTCAGCGCACGGAGT
TCAGCGCACGGAGTAAGGCCTACTACCCGA|GTAGTCGACGCTATAATACCGCAGGTACTG
GAGGAGCAAGTTCCGAGTCACACACTTTGG|TACCACGGCCGAGCTCTTTCCTGTCGGACC
AGGGATAGCGGTCAGCGCACGGAGTAAGGC|ACGGGGGGAGCTAGTGGCTCCATTAGGGTC
GACGGTGTCTATGTCATTAGGGTCAGCGCA|CACGGAGTAAGGCCTACTACCCGCTGGGGA
CTAACCTCAAAGGAAGAGAAAGGGATAGCG|AGTCGAGCAGGAAGACTTCTACGGGGGGAG
ATCCCTATTCAAAGGTACGGAAGGTCGGTC|GGGATGCTATGACGGTGTCTATGTCATTAG
GGAGTAAGGCCTACTACCCGCTGGGGAGGT|CATTAGGGTCAGCGCACGGAGTAAGGCCTA
AAGCTGTTCGGTGGTCATGGCCGACGTTTA|CACGGAGTAAGGCCTACTACCCCACTCCAT
CGGTGGTCATGGCCGACGTTTAACCGAGTG|AAGGCCTACTACCCCACTCCATACTAACCT
AATACCGCAGGTACTGTGTGATACCGGTCA|AATACCACTGTAGCTTACACACAAGCTTGA
AGGGTCAGCGCACGGAGTAAGGCCTACTAC|CGTCAGCGCACGGAGTAAGGCCTACTACCC
TTTCTCGGCCGGTGATTTTCTTAGGGACGG|CCCCGTGAATTGAAAGCTGTTCGGTGGTCA
GCACGGAGTAAGGCCTACTACCCGAGGAAA|ACATCGCGATTTTATCTTCAGCAGCCCTGA
CCGAGTGTCCATACAGGAGCGCCACGCGGG|CTAACCTCAAAGGAAGAGAAAGGGATAGCG
GATGCATCTAGCTCGAATTTTGTAACCCTG|TGTGTGATACCGGTCAGCGCACGGAGTAAG
CGCACGGAGTAAGGCCTACTACCCATACCC|TCAGCGCACGGAGTAAGGCCTACTACCCGG
CGGAGTAAGGCCTACTACCCGGCCTACTAC|AGTCATGGCTCACCAAAGGTTACGTGCCCA
CAGCGCACGGAGTAAGGCCTACTACCCGGC|CTGGGGAGGTCAGCGCACGGAGTAAGGCCT
CGAGGAAACTCTCGAGGAGCAAGTTCCGAG|AGCCCTGAGCCGGTACCACGGCCGAGCTCT
GAGTAAGGCCTACTACCCTTCGGTCAGCGC|AATGCCCTACCGAACACTTGATCATCCCAC
ATACTAACCTCAAAGGAAGAGAAAGGGATA|CCTAGTCGAGCAGGAAGACTTCTACGGGGG
GATTTATAGCTGGTCAGCGCACGGAGTAAG|TTTATGTACAGCAAACATATCGTCGTACGA
GGCCTACTACCCCTTCCAGAAACGTCAGCA|AGATAATCACGCAATTGTTCACCAGTATCA
GACCTCCAATACCACTGTAGCTTACACACA|TAGCAAACGCTTAAACTCTCCGGTAGAACC
CATCCCACATCGCGATTTTATCTTCAGCAG|CACGCCATATGTCATGGTCAGCGCACGGAG
GTAAGGCCTACTACCCATTCGTTAGGGGTC|AGATAATGCGCCTGTACCAGGTGCACATAT
TACTACCCGAGGAAACTCTCGAGGAGCAAG|CTTCAGCAGCCCTGAGCCGGTACCACGGCC
CCCATCAGTCACACCATGCATGCCTAGACC|GAAAAGGTTACCTACTTCAATTGTGATAGC
CCGGTTAGGAAACGTGTAGTCGACGCTATA|TCAGTCACACCATGCATGCCTAGACCTCCA
AGCGGTCAGCGCACGGAGTAAGGCCTACTA|GGAGCTAGTGGCTCCATTAGGGTCAGCGCA
ATGCATGCCTAGACCTCCAATACCACTGTA|TTCAATTGTGATAGCAAACGCTTAAACTCT
GCGCACGGAGTAAGGCCTACTACCCGATGC|GTCGACGCTATAATACCGCAGGTACTGTGT
TCAGCGCACGGAGTAAGGCCTACTACCCAT|ACTACCCCCTCAAGATAATGCGCCTGTACC
GTTCCGAGTCACACACTTTGGTTATGGGTC|CGAGCTCTTTCCTGTCGGACCCTTCTAAAG
CGGAGTAAGGCCTACTACCCCACTCCATAC|GTTAGGGGTCAATCCAGGCGCGGGCTCCTA
CCTACTACCCTTCGGTCAGCGCACGGAGTA|ACCGAACACTTGATCATCCCACATCGCGAT
CCTACTACCCGCTGGGGAGGTCAGCGCACG|CAGCGCACGGAGTAAGGCCTACTACCCCCT
CTCGTGACTTGGTTTCTCATCCCTATTCAA|CATACAGGAGCGCCACGCGGGATGCTATGA
GCGCCTGTACCAGGTGCACATATGGAAGAG|GGAGTAAGGCCTACTACCCGAGGAAACTCT
CGGGGGGAGCTAGTGGCTCCATTAGGGTCA|CGCACGGAGTAAGGCCTACTACCCGTCAGC
GGGATAGCGGTCAGCGCACGGAGTAAGGCC|CGGGGGGAGCTAGTGGCTCCATTAGGGTCA
GTAAGGCCTACTACCCTTCGGTCAGCGCAC|TGCCCTACCGAACACTTGATCATCCCACAT
GTTATGGGTCAGCGCACGGAGTAAGGCCTA|CCTTCTAAAGCGGCTGATAGTCCGGGCGAG
AACCGAGTGTCCATACAGGAGCGCCACGCG|TACTAACCTCAAAGGAAGAGAAAGGGATAG
CGTGCCCATCAGTCACACCATGCATGCCTA|GACAGAAAAGGTTACCTACTTCAATTGTGA
GGTCAATCCAGGCGCGGGCTCCTAGTCGAG|ATATGGAAGAGCACAGTTGTTCGGCAGAGG
CCTCAAGATAATGCGCCTGTACCAGGTGCA|CGGTCAGCGCACGGAGTAAGGCCTACTACC
TTATCTTCAGCAGCCCTGAGCCGGTACCAC|TCAGCGCACGGAGTAAGGCCTACTACCCGA
CGGAGTAAGGCCTACTACCCGCTGGGGAGG|CCATTAGGGTCAGCGCACGGAGTAAGGCCT
TGGTTATGGGTCAGCGCACGGAGTAAGGCC|ACCCTTCTAAAGCGGCTGATAGTCCGGGCG
GGAAAGAGCTGGAAGAAGTCATGGCTCACC|AAGGCCTACTACCCCTTCCAGAAACGTCAG
GACGGATTGATTCTCAGACGTTATTACACT|GGTCATGGCCGACGTTTAACCGAGTGTCCA
TGGAAGAAGTCATGGCTCACCAAAGGTTAC|TACCCCTTCCAGAAACGTCAGCACATAGCG
AGTAAGGCCTACTACCCGAAATGCCCTACC|GTCCGGGCGAGTGAGACAAACGCGCGCAAG
AATGCGCCTGTACCAGGTGCACATATGGAA|CACGGAGTAAGGCCTACTACCCGAGGAAAC
GCCTACTACCCGGTTAGGAAACGTGTAGTC|ACGTGCCCATCAGTCACACCATGCATGCCT
TTGTAACCCTGGTCAGCGCACGGAGTAAGG|CACGGAGTAAGGCCTACTACCCGGAAAGAG
CTATAATACCGCAGGTACTGTGTGATACCG|CTCCAATACCACTGTAGCTTACACACAAGC
CCGGTACCACGGCCGAGCTCTTTCCTGTCG|TACTACCCGATGCATCTAGCTCGAATTTTG
CTCGAGGAGCAAGTTCCGAGTCACACACTT|CGGTACCACGGCCGAGCTCTTTCCTGTCGG
CAGCGCACGGAGTAAGGCCTACTACCCCCT|GCGCACGGAGTAAGGCCTACTACCCTTCGG
AGCGCACGGAGTAAGGTCAGCGCACGGAGT|TACTACCCGGAAAGAGCTGGAAGAAGTCAT
CGCACGGAGTAAGGCCTACTACCCGGAAAG|TTATAGCTGGTCAGCGCACGGAGTAAGGCC
CCCTTCCAGAAACGTCAGCACATAGCGACA|GCAATTGTTCACCAGTATCACTCAGCGCTT
ACTCTCGAGGAGCAAGTTCCGAGTCACACA|AGCCGGTACCACGGCCGAGCTCTTTCCTGT
GGTCAGCGCACGGAGTAAGGTCAGCGCACG|GGCCTACTACCCGGAAAGAGCTGGAAGAAG
CCCGTCAGCGCACGGAGTAAGGCCTACTAC|GGCCTACTACCCGAAATGCCCTACCGAACA
TCAGCAGCCCTGAGCCGGTACCACGGCCGA|CACGGAGTAAGGCCTACTACCCGATGCATC
GTAAAGCTAGGGTCTATTTCTCGGCCGGTG|AGGCCTACTACCCATACCCCGTGAATTGAA
AGTAAGGCCTACTACCCATACCCCGTGAAT|ACGGAGTAAGGCCTACTACCCGGCTGGTCA
GCTCTTTCCTGTCGGACCCTTCTAAAGCGG|TAGCTCGAATTTTGTAACCCTGGTCAGCGC
ATGCTATGACGGTGTCTATGTCATTAGGGT|GTCAGCGCACGGAGTAAGGCCTACTACCCG
AAAGCGGCTGATAGTCCGGGCGAGTGAGAC|TCAGCGCACGGAGTAAGGTCAGCGCACGGA
CAAGTTCCGAGTCACACACTTTGGTTATGG|GGCCGAGCTCTTTCCTGTCGGACCCTTCTA
GTCAGCGCACGGAGTAAGGCCTACTACCCG|AAGCGGCTGATAGTCCGGGCGAGTGAGACA
GTCAGCGCACGGAGTAAGGCCTACTACCCG|CTAGTGGCTCCATTAGGGTCAGCGCACGGA
TACCCGATGCATCTAGCTCGAATTTTGTAA|GGTACTGTGTGATACCGGTCAGCGCACGGA
GGGGAGCTAGTGGCTCCATTAGGGTCAGCG|ACGGAGTAAGGCCTACTACCCGTCAGCGCA
ACGGAGTAAGGTCAGCGCACGGAGTAAGGC|CCCGGAAAGAGCTGGAAGAAGTCATGGCTC
GGAGTAAGGCCTACTACCCATACCCCGTGA|GCACGGAGTAAGGCCTACTACCCGGCTGGT
TCAGCGCACGGAGTAAGGCCTACTACCCGA|AGCGGCTGATAGTCCGGGCGAGTGAGACAA
TGATTCTCAGACGTTATTACACTCGTGACT|GCCGACGTTTAACCGAGTGTCCATACAGGA
TGATTTTCTTAGGGACGGATTGATTCTCAG|AAAGCTGTTCGGTGGTCATGGCCGACGTTT
CGGTGATTTTCTTAGGGACGGATTGATTCT|TTGAAAGCTGTTCGGTGGTCATGGCCGACG
CTACTACCCGATGCATCTAGCTCGAATTTT|CGCAGGTACTGTGTGATACCGGTCAGCGCA
AGCGCACGGAGTAAGGCCTACTACCCCTTC|CATATCGTCGTACGAGATAATCACGCAATT
CACGGAGTAAGGCCTACTACCCCTTCCAGA|TCGTCGTACGAGATAATCACGCAATTGTTC
CTAAAGCGGCTGATAGTCCGGGCGAGTGAG|GGTCAGCGCACGGAGTAAGGTCAGCGCACG
GGGTCAGCGCACGGAGTAAGGCCTACTACC|TAAAGCGGCTGATAGTCCGGGCGAGTGAGA
TGGTTTCTCATCCCTATTCAAAGGTACGGA|GCGCCACGCGGGATGCTATGACGGTGTCTA
TCGGCAGAGGTGGTCCCGGGTCAGCGCACG|AGTTCCGAGTCACACACTTTGGTTATGGGT
GAAACTCTCGAGGAGCAAGTTCCGAGTCAC|CTGAGCCGGTACCACGGCCGAGCTCTTTCC
AAGGCCTACTACCCGTCAGCGCACGGAGTA|GCACGGAGTAAGGCCTACTACCCGAAATGC
CGAGTCACACACTTTGGTTATGGGTCAGCG|CTCTTTCCTGTCGGACCCTTCTAAAGCGGC
TTACACTCGTGACTTGGTTTCTCATCCCTA|GTGTCCATACAGGAGCGCCACGCGGGATGC
GTCAGCGCACGGAGTAAGGCCTACTACCCC|TACCCATTCGTTAGGGGTCAATCCAGGCGC
GACGTTATTACACTCGTGACTTGGTTTCTC|TAACCGAGTGTCCATACAGGAGCGCCACGC
CTGATAGTCCGGGCGAGTGAGACAAACGCG|ACGGAGTAAGGTCAGCGCACGGAGTAAGGC
TTCTACGGGGGGAGCTAGTGGCTCCATTAG|GTCAGCGCACGGAGTAAGGCCTACTACCCG
CATGCATGCCTAGACCTCCAATACCACTGT|CTTCAATTGTGATAGCAAACGCTTAAACTC
AGCGCACGGAGTAAGGCCTACTACCCTTCG|CTACCCGAAATGCCCTACCGAACACTTGAT
CATCAGTCACACCATGCATGCCTAGACCTC|AAAGGTTACCTACTTCAATTGTGATAGCAA
GTCAGCGCACGGAGTAAGGCCTACTACCCG|CATCCCACATCGCGATTTTATCTTCAGCAG
GAGCCGGTACCACGGCCGAGCTCTTTCCTG|GCCTACTACCCGATGCATCTAGCTCGAATT
TACACACAAGCTTGATTTATAGCTGGTCAG|GTAGAACCCGTCCTTTATGTACAGCAAACA
GAGTAAGGCCTACTACCCGGCCTACTACCC|TCATGGCTCACCAAAGGTTACGTGCCCATC
CCGTGAATTGAAAGCTGTTCGGTGGTCATG|GCTGGTCAGCGCACGGAGTAAGGCCTACTA
GCGCAAGAATTCGGGACGCACGCCATATGT|CCTACTACCCGGCCTACTACCCGGTTAGGA
AGTCGACGCTATAATACCGCAGGTACTGTG|GCCTAGACCTCCAATACCACTGTAGCTTAC
CCCTCAAGATAATGCGCCTGTACCAGGTGC|TCGGTCAGCGCACGGAGTAAGGCCTACTAC
GGAGTAAGGCCTACTACCCGGCCTACTACC|GTCATGGCTCACCAAAGGTTACGTGCCCAT
ATTCAAAGGTACGGAAGGTCGGTCAGCGCA|CTATGACGGTGTCTATGTCATTAGGGTCAG
GTAAGGCCTACTACCCCACTCCATACTAAC|GGGGTCAATCCAGGCGCGGGCTCCTAGTCG
AGTCGAGCAGGAAGACTTCTACGGGGGGAG|GCAGAGGTGGTCCCGGGTCAGCGCACGGAG
GCCGGTACCACGGCCGAGCTCTTTCCTGTC|CTACTACCCGATGCATCTAGCTCGAATTTT
GCTAGTGGCTCCATTAGGGTCAGCGCACGG|GTAAGGCCTACTACCCGTCAGCGCACGGAG
CGCAAGAATTCGGGACGCACGCCATATGTC|CTACTACCCGGCCTACTACCCGGTTAGGAA
GTCAGCGCACGGAGTAAGGCCTACTACCCG|TTGATTTATAGCTGGTCAGCGCACGGAGTA
TAACCGAGTGTCCATACAGGAGCGCCACGC|ATACTAACCTCAAAGGAAGAGAAAGGGATA
GTCGAGCAGGAAGACTTCTACGGGGGGAGC|CAGAGGTGGTCCCGGGTCAGCGCACGGAGT
AGAGGTGGTCCCGGGTCAGCGCACGGAGTA|CGAGTCACACACTTTGGTTATGGGTCAGCG
TATAATACCGCAGGTACTGTGTGATACCGG|TCCAATACCACTGTAGCTTACACACAAGCT
ATTGATTCTCAGACGTTATTACACTCGTGA|TGGCCGACGTTTAACCGAGTGTCCATACAG
CTTTGGTTATGGGTCAGCGCACGGAGTAAG|CGGACCCTTCTAAAGCGGCTGATAGTCCGG
CATGGCTCACCAAAGGTTACGTGCCCATCA|AGAAACGTCAGCACATAGCGACAGAAAAGG
AAAGGTTACGTGCCCATCAGTCACACCATG|CACATAGCGACAGAAAAGGTTACCTACTTC
CTACCCGGCCTACTACCCGGTTAGGAAACG|AAAGGTTACGTGCCCATCAGTCACACCATG
AGGTGGTCCCGGGTCAGCGCACGGAGTAAG|AGTCACACACTTTGGTTATGGGTCAGCGCA
GAAACGTGTAGTCGACGCTATAATACCGCA|ACCATGCATGCCTAGACCTCCAATACCACT
TTTATCTTCAGCAGCCCTGAGCCGGTACCA|GTCAGCGCACGGAGTAAGGCCTACTACCCG
GGTCAGCGCACGGAGTAAGGCCTACTACCC|AAAGCGGCTGATAGTCCGGGCGAGTGAGAC
GATAGTCCGGGCGAGTGAGACAAACGCGCG|GGAGTAAGGTCAGCGCACGGAGTAAGGCCT
CGGTCAGCGCACGGAGTAAGGCCTACTACC|AGCTAGTGGCTCCATTAGGGTCAGCGCACG
TTAGGGTCAGCGCACGGAGTAAGGCCTACT|CCCGTCAGCGCACGGAGTAAGGCCTACTAC
TACCCGAAATGCCCTACCGAACACTTGATC|GAGACAAACGCGCGCAAGAATTCGGGACGC
CGAGTGAGACAAACGCGCGCAAGAATTCGG|AGCGCACGGAGTAAGGCCTACTACCCGGCC
AAGAGCTGGAAGAAGTCATGGCTCACCAAA|GCCTACTACCCCTTCCAGAAACGTCAGCAC
ACGGAGTAAGGCCTACTACCCTTCGGTCAG|CGAAATGCCCTACCGAACACTTGATCATCC
CAGCGCACGGAGTAAGGCCTACTACCCGGA|GATTTATAGCTGGTCAGCGCACGGAGTAAG
CCAGGCGCGGGCTCCTAGTCGAGCAGGAAG|AGAGCACAGTTGTTCGGCAGAGGTGGTCCC
CAGCGCACGGAGTAAGGCCTACTACCCGCT|AGTGGCTCCATTAGGGTCAGCGCACGGAGT
AATGCCCTACCGAACACTTGATCATCCCAC|ACGCGCGCAAGAATTCGGGACGCACGCCAT
CCCGGCTGGTCAGCGCACGGAGTAAGGCCT|AGGCCTACTACCCATTCGTTAGGGGTCAAT
CGAGGAGCAAGTTCCGAGTCACACACTTTG|GTACCACGGCCGAGCTCTTTCCTGTCGGAC
ACTAACCTCAAAGGAAGAGAAAGGGATAGC|TAGTCGAGCAGGAAGACTTCTACGGGGGGA
ACGCACGCCATATGTCATGGTCAGCGCACG|ACTACCCGGTTAGGAAACGTGTAGTCGACG
CCTACTACCCATACCCCGTGAATTGAAAGC|AAGGCCTACTACCCGGCTGGTCAGCGCACG
CACGCCATATGTCATGGTCAGCGCACGGAG|ACCCGGTTAGGAAACGTGTAGTCGACGCTA
TCCATTAGGGTCAGCGCACGGAGTAAGGCC|ACTACCCGTCAGCGCACGGAGTAAGGCCTA
GAGCAGGAAGACTTCTACGGGGGGAGCTAG|AGGTGGTCCCGGGTCAGCGCACGGAGTAAG
TGTAGTCGACGCTATAATACCGCAGGTACT|CATGCCTAGACCTCCAATACCACTGTAGCT
ACTACCCCACTCCATACTAACCTCAAAGGA|CCAGGCGCGGGCTCCTAGTCGAGCAGGAAG
CCGGAAAGAGCTGGAAGAAGTCATGGCTCA|GTAAGGCCTACTACCCCTTCCAGAAACGTC
TGGTCAGCGCACGGAGTAAGGCCTACTACC|ACTACCCATTCGTTAGGGGTCAATCCAGGC
TCATTAGGGTCAGCGCACGGAGTAAGGCCT|CTACTACCCGCTGGGGAGGTCAGCGCACGG
GGGTCTATTTCTCGGCCGGTGATTTTCTTA|ACCCATACCCCGTGAATTGAAAGCTGTTCG
GCCTACTACCCGAAATGCCCTACCGAACAC|GCGAGTGAGACAAACGCGCGCAAGAATTCG
GTCCGGGCGAGTGAGACAAACGCGCGCAAG|TAAGGTCAGCGCACGGAGTAAGGCCTACTA
ACGGAGTAAGGCCTACTACCCGCTGGGGAG|TCCATTAGGGTCAGCGCACGGAGTAAGGCC
GGTACGGAAGGTCGGTCAGCGCACGGAGTA|GGTGTCTATGTCATTAGGGTCAGCGCACGG
CTACCCATTCGTTAGGGGTCAATCCAGGCG|CCTGTACCAGGTGCACATATGGAAGAGCAC
AGCGCACGGAGTAAGGCCTACTACCCATTC|TACCCCCTCAAGATAATGCGCCTGTACCAG
CGGATTGATTCTCAGACGTTATTACACTCG|TCATGGCCGACGTTTAACCGAGTGTCCATA
GTAGCTTACACACAAGCTTGATTTATAGCT|TCTCCGGTAGAACCCGTCCTTTATGTACAG
GCACGGAGTAAGGCCTACTACCCCTTCCAG|ATCGTCGTACGAGATAATCACGCAATTGTT
GGCCTACTACCCATACCCCGTGAATTGAAA|GTAAGGCCTACTACCCGGCTGGTCAGCGCA
CACGGAGTAAGGCCTACTACCCCCTCAAGA|CGGAGTAAGGCCTACTACCCTTCGGTCAGC
TACCCCACTCCATACTAACCTCAAAGGAAG|AGGCGCGGGCTCCTAGTCGAGCAGGAAGAC
GTCATTAGGGTCAGCGCACGGAGTAAGGCC|CCTACTACCCGCTGGGGAGGTCAGCGCACG
ACACACTTTGGTTATGGGTCAGCGCACGGA|CCTGTCGGACCCTTCTAAAGCGGCTGATAG
GCACGGAGTAAGGCCTACTACCCATACCCC|CAGCGCACGGAGTAAGGCCTACTACCCGGC
GTACTGTGTGATACCGGTCAGCGCACGGAG|TAGCTTACACACAAGCTTGATTTATAGCTG
CAGGTGCACATATGGAAGAGCACAGTTGTT|CTACTACCCGAGGAAACTCTCGAGGAGCAA
GAGTCACACACTTTGGTTATGGGTCAGCGC|TCTTTCCTGTCGGACCCTTCTAAAGCGGCT
CAAACGCGCGCAAGAATTCGGGACGCACGC|AGTAAGGCCTACTACCCGGCCTACTACCCG
AGGCCTACTACCCGCTGGGGAGGTCAGCGC|GGTCAGCGCACGGAGTAAGGCCTACTACCC
ATCCAGGCGCGGGCTCCTAGTCGAGCAGGA|GAAGAGCACAGTTGTTCGGCAGAGGTGGTC
GGCTCCATTAGGGTCAGCGCACGGAGTAAG|CCTACTACCCGTCAGCGCACGGAGTAAGGC
CCAATACCACTGTAGCTTACACACAAGCTT|AACGCTTAAACTCTCCGGTAGAACCCGTCC
AGGTACGGAAGGTCGGTCAGCGCACGGAGT|CGGTGTCTATGTCATTAGGGTCAGCGCACG
TGGGGAGGTCAGCGCACGGAGTAAGGCCTA|TAAGGCCTACTACCCCCTCAAGATAATGCG
GGAGTAAGGCCTACTACCCGATGCATCTAG|GCTATAATACCGCAGGTACTGTGTGATACC
GGTTATGGGTCAGCGCACGGAGTAAGGCCT|CCCTTCTAAAGCGGCTGATAGTCCGGGCGA
AGTAAAGCTAGGGTCTATTTCTCGGCCGGT|AAGGCCTACTACCCATACCCCGTGAATTGA
GCGCACGGAGTAAGGCCTACTACCCGAAAT|GGCTGATAGTCCGGGCGAGTGAGACAAACG
CCACTGTAGCTTACACACAAGCTTGATTTA|TAAACTCTCCGGTAGAACCCGTCCTTTATG
GGGATGCTATGACGGTGTCTATGTCATTAG|GCGGTCAGCGCACGGAGTAAGGCCTACTAC
GGGGAGGTCAGCGCACGGAGTAAGGCCTAC|AAGGCCTACTACCCCCTCAAGATAATGCGC
AGACTTCTACGGGGGGAGCTAGTGGCTCCA|CCGGGTCAGCGCACGGAGTAAGGCCTACTA
CGTGTAGTCGACGCTATAATACCGCAGGTA|TGCATGCCTAGACCTCCAATACCACTGTAG
ATACAGGAGCGCCACGCGGGATGCTATGAC|AGGAAGAGAAAGGGATAGCGGTCAGCGCAC
TCATGGTCAGCGCACGGAGTAAGGCCTACT|AAACGTGTAGTCGACGCTATAATACCGCAG
AAGGCCTACTACCCGGCTGGTCAGCGCACG|CGCACGGAGTAAGGCCTACTACCCATTCGT
GCCTGTACCAGGTGCACATATGGAAGAGCA|AGTAAGGCCTACTACCCGAGGAAACTCTCG
ATGCCTAGACCTCCAATACCACTGTAGCTT|ATTGTGATAGCAAACGCTTAAACTCTCCGG
GTAAGGCCTACTACCCGGCCTACTACCCGG|ATGGCTCACCAAAGGTTACGTGCCCATCAG
ACACCATGCATGCCTAGACCTCCAATACCA|CCTACTTCAATTGTGATAGCAAACGCTTAA
TTTCTTAGGGACGGATTGATTCTCAGACGT|CTGTTCGGTGGTCATGGCCGACGTTTAACC
TCAGCGCACGGAGTAAGGCCTACTACCCTT|TACTACCCGAAATGCCCTACCGAACACTTG
ACTACCCGCTGGGGAGGTCAGCGCACGGAG|CGCACGGAGTAAGGCCTACTACCCCCTCAA
CCTTCCAGAAACGTCAGCACATAGCGACAG|CAATTGTTCACCAGTATCACTCAGCGCTTC
CTGGGGAGGTCAGCGCACGGAGTAAGGCCT|GTAAGGCCTACTACCCCCTCAAGATAATGC
TGATACCGGTCAGCGCACGGAGTAAGGCCT|ACACAAGCTTGATTTATAGCTGGTCAGCGC
GCCTACTACCCATACCCCGTGAATTGAAAG|TAAGGCCTACTACCCGGCTGGTCAGCGCAC
CTAGACCTCCAATACCACTGTAGCTTACAC|TGATAGCAAACGCTTAAACTCTCCGGTAGA
TCCCACATCGCGATTTTATCTTCAGCAGCC|CGCCATATGTCATGGTCAGCGCACGGAGTA
CTAGTGGCTCCATTAGGGTCAGCGCACGGA|TAAGGCCTACTACCCGTCAGCGCACGGAGT
TATGTCATGGTCAGCGCACGGAGTAAGGCC|TAGGAAACGTGTAGTCGACGCTATAATACC
AAAGGGATAGCGGTCAGCGCACGGAGTAAG|CTACGGGGGGAGCTAGTGGCTCCATTAGGG
CGGTCAGCGCACGGAGTAAGGCCTACTACC|GCTTGATTTATAGCTGGTCAGCGCACGGAG
CACACTTTGGTTATGGGTCAGCGCACGGAG|CTGTCGGACCCTTCTAAAGCGGCTGATAGT
TCAATCCAGGCGCGGGCTCCTAGTCGAGCA|ATGGAAGAGCACAGTTGTTCGGCAGAGGTG
AGGTGCACATATGGAAGAGCACAGTTGTTC|TACTACCCGAGGAAACTCTCGAGGAGCAAG
AGTAAGGCCTACTACCCCTTCCAGAAACGT|GTACGAGATAATCACGCAATTGTTCACCAG
GTGCACATATGGAAGAGCACAGTTGTTCGG|CTACCCGAGGAAACTCTCGAGGAGCAAGTT
CCTACTACCCGATGCATCTAGCTCGAATTT|CCGCAGGTACTGTGTGATACCGGTCAGCGC
GAGTAAGGCCTACTACCCCACTCCATACTA|TAGGGGTCAATCCAGGCGCGGGCTCCTAGT
TGCCCTACCGAACACTTGATCATCCCACAT|GCGCGCAAGAATTCGGGACGCACGCCATAT
GAAGACTTCTACGGGGGGAGCTAGTGGCTC|TCCCGGGTCAGCGCACGGAGTAAGGCCTAC
GCGCGCAAGAATTCGGGACGCACGCCATAT|GGCCTACTACCCGGCCTACTACCCGGTTAG
CCCTGAGCCGGTACCACGGCCGAGCTCTTT|TAAGGCCTACTACCCGATGCATCTAGCTCG
GCCGAGCTCTTTCCTGTCGGACCCTTCTAA|GCATCTAGCTCGAATTTTGTAACCCTGGTC
AGCACAGTTGTTCGGCAGAGGTGGTCCCGG|CTCGAGGAGCAAGTTCCGAGTCACACACTT
AGCTTACACACAAGCTTGATTTATAGCTGG|TCCGGTAGAACCCGTCCTTTATGTACAGCA
TAGGGTCAGCGCACGGAGTAAGGCCTACTA|CCGTCAGCGCACGGAGTAAGGCCTACTACC
CGCACGGAGTAAGGCCTACTACCCCACTCC|ATTCGTTAGGGGTCAATCCAGGCGCGGGCT
CACGGAGTAAGGCCTACTACCCGAAATGCC|TGATAGTCCGGGCGAGTGAGACAAACGCGC
AGTAAGGCCTACTACCCGGCTGGTCAGCGC|CAGCGCACGGAGTAAGGCCTACTACCCATT
AGTTCCGAGTCACACACTTTGGTTATGGGT|CCGAGCTCTTTCCTGTCGGACCCTTCTAAA
AAACGTGTAGTCGACGCTATAATACCGCAG|CCATGCATGCCTAGACCTCCAATACCACTG
GGGTCAGCGCACGGAGTAAGGCCTACTACC|GTCAGCGCACGGAGTAAGGCCTACTACCCT
CCCGGCCTACTACCCGGTTAGGAAACGTGT|GGTTACGTGCCCATCAGTCACACCATGCAT
AGAAGTCATGGCTCACCAAAGGTTACGTGC|CCTTCCAGAAACGTCAGCACATAGCGACAG
AGTGTCCATACAGGAGCGCCACGCGGGATG|ACCTCAAAGGAAGAGAAAGGGATAGCGGTC
TAAGGCCTACTACCCGGCTGGTCAGCGCAC|GCGCACGGAGTAAGGCCTACTACCCATTCG
CCTGTCGGACCCTTCTAAAGCGGCTGATAG|AATTTTGTAACCCTGGTCAGCGCACGGAGT
CTGTGTGATACCGGTCAGCGCACGGAGTAA|CTTACACACAAGCTTGATTTATAGCTGGTC
CTACCGAACACTTGATCATCCCACATCGCG|GCAAGAATTCGGGACGCACGCCATATGTCA
AAGGCCTACTACCCGGAAAGAGCTGGAAGA|TCAGCGCACGGAGTAAGGCCTACTACCCCT
TAACCCTGGTCAGCGCACGGAGTAAGGTCA|GGAGTAAGGCCTACTACCCGGAAAGAGCTG
TATAGCTGGTCAGCGCACGGAGTAAGGCCT|TGTACAGCAAACATATCGTCGTACGAGATA
GGACGCACGCCATATGTCATGGTCAGCGCA|CTACTACCCGGTTAGGAAACGTGTAGTCGA
TCTTTCCTGTCGGACCCTTCTAAAGCGGCT|GCTCGAATTTTGTAACCCTGGTCAGCGCAC
TCATCCCTATTCAAAGGTACGGAAGGTCGG|GCGGGATGCTATGACGGTGTCTATGTCATT
ACTACCCGTCAGCGCACGGAGTAAGGCCTA|GTAAGGCCTACTACCCGAAATGCCCTACCG
AAGGCCTACTACCCGATGCATCTAGCTCGA|AATACCGCAGGTACTGTGTGATACCGGTCA
TGAGCCGGTACCACGGCCGAGCTCTTTCCT|GGCCTACTACCCGATGCATCTAGCTCGAAT
GGCTGGTCAGCGCACGGAGTAAGGCCTACT|CCTACTACCCATTCGTTAGGGGTCAATCCA
TACCCCTTCCAGAAACGTCAGCACATAGCG|CACGCAATTGTTCACCAGTATCACTCAGCG
GCTTACACACAAGCTTGATTTATAGCTGGT|CCGGTAGAACCCGTCCTTTATGTACAGCAA
AGTAAGGCCTACTACCCGCTGGGGAGGTCA|TTAGGGTCAGCGCACGGAGTAAGGCCTACT
AGGCCTACTACCCATACCCCGTGAATTGAA|AGTAAGGCCTACTACCCGGCTGGTCAGCGC
TACTACCCGTCAGCGCACGGAGTAAGGCCT|AGTAAGGCCTACTACCCGAAATGCCCTACC
TGCCTAGACCTCCAATACCACTGTAGCTTA|TTGTGATAGCAAACGCTTAAACTCTCCGGT
CGCACGGAGTAAGGCCTACTACCCGATGCA|TCGACGCTATAATACCGCAGGTACTGTGTG
GCACATATGGAAGAGCACAGTTGTTCGGCA|ACCCGAGGAAACTCTCGAGGAGCAAGTTCC
GGTCAGCGCACGGAGTAAGGCCTACTACCC|CCGCTGGGGAGGTCAGCGCACGGAGTAAGG
CGGAGTAAGGCCTACTACCCGTCAGCGCAC|GTCAGCGCACGGAGTAAGGCCTACTACCCG
TCGGCCGGTGATTTTCTTAGGGACGGATTG|GTGAATTGAAAGCTGTTCGGTGGTCATGGC
GTAAGGCCTACTACCCGCTGGGGAGGTCAG|TAGGGTCAGCGCACGGAGTAAGGCCTACTA
ACCCGGCCTACTACCCGGTTAGGAAACGTG|AGGTTACGTGCCCATCAGTCACACCATGCA
AGATAATGCGCCTGTACCAGGTGCACATAT|AGCGCACGGAGTAAGGCCTACTACCCGAGG
GGCCTACTACCCGCTGGGGAGGTCAGCGCA|GTCAGCGCACGGAGTAAGGCCTACTACCCC
GGAGTAAGGCCTACTACCCCCTCAAGATAA|AGTAAGGCCTACTACCCTTCGGTCAGCGCA
CATACAGGAGCGCCACGCGGGATGCTATGA|AAGGAAGAGAAAGGGATAGCGGTCAGCGCA
CCGATGCATCTAGCTCGAATTTTGTAACCC|ACTGTGTGATACCGGTCAGCGCACGGAGTA
AAACTCTCGAGGAGCAAGTTCCGAGTCACA|TGAGCCGGTACCACGGCCGAGCTCTTTCCT
ACGCTATAATACCGCAGGTACTGTGTGATA|GACCTCCAATACCACTGTAGCTTACACACA
GTACCACGGCCGAGCTCTTTCCTGTCGGAC|TACCCGATGCATCTAGCTCGAATTTTGTAA
GAGTAAGGCCTACTACCCGCTGGGGAGGTC|ATTAGGGTCAGCGCACGGAGTAAGGCCTAC
GTCAGCGCACGGAGTAAGGTCAGCGCACGG|GCCTACTACCCGGAAAGAGCTGGAAGAAGT
AAAGCTGTTCGGTGGTCATGGCCGACGTTT|GCACGGAGTAAGGCCTACTACCCCACTCCA
GGCCGGTGATTTTCTTAGGGACGGATTGAT|GAATTGAAAGCTGTTCGGTGGTCATGGCCG
CCCATACCCCGTGAATTGAAAGCTGTTCGG|ACTACCCGGCTGGTCAGCGCACGGAGTAAG
AACCTCAAAGGAAGAGAAAGGGATAGCGGT|TCGAGCAGGAAGACTTCTACGGGGGGAGCT
TACCCGGCCTACTACCCGGTTAGGAAACGT|AAGGTTACGTGCCCATCAGTCACACCATGC
TCGAATTTTGTAACCCTGGTCAGCGCACGG|GTCAGCGCACGGAGTAAGGCCTACTACCCG
TTGAAAGCTGTTCGGTGGTCATGGCCGACG|AGCGCACGGAGTAAGGCCTACTACCCCACT
AGGAAACGTGTAGTCGACGCTATAATACCG|ACACCATGCATGCCTAGACCTCCAATACCA
ACGGAGTAAGGCCTACTACCCGAGGAAACT|ATCGCGATTTTATCTTCAGCAGCCCTGAGC
GACGTTTAACCGAGTGTCCATACAGGAGCG|CACTCCATACTAACCTCAAAGGAAGAGAAA
AGTAAGGTCAGCGCACGGAGTAAGGCCTAC|GAAAGAGCTGGAAGAAGTCATGGCTCACCA
CCTACTACCCGAAATGCCCTACCGAACACT|CGAGTGAGACAAACGCGCGCAAGAATTCGG
AGGCCTACTACCCGAGGAAACTCTCGAGGA|TTTATCTTCAGCAGCCCTGAGCCGGTACCA
GCTCCTAGTCGAGCAGGAAGACTTCTACGG|TGTTCGGCAGAGGTGGTCCCGGGTCAGCGC
GTCAATCCAGGCGCGGGCTCCTAGTCGAGC|TATGGAAGAGCACAGTTGTTCGGCAGAGGT
TACCACTGTAGCTTACACACAAGCTTGATT|CTTAAACTCTCCGGTAGAACCCGTCCTTTA
TCGTTAGGGGTCAATCCAGGCGCGGGCTCC|AGGTGCACATATGGAAGAGCACAGTTGTTC
GTCTATTTCTCGGCCGGTGATTTTCTTAGG|CCATACCCCGTGAATTGAAAGCTGTTCGGT
GGCCTACTACCCCACTCCATACTAACCTCA|TCAATCCAGGCGCGGGCTCCTAGTCGAGCA
CGAGCAGGAAGACTTCTACGGGGGGAGCTA|GAGGTGGTCCCGGGTCAGCGCACGGAGTAA
TGAGACAAACGCGCGCAAGAATTCGGGACG|CACGGAGTAAGGCCTACTACCCGGCCTACT
GGGACGCACGCCATATGTCATGGTCAGCGC|CCTACTACCCGGTTAGGAAACGTGTAGTCG
TACCCGGTTAGGAAACGTGTAGTCGACGCT|CCATCAGTCACACCATGCATGCCTAGACCT
GGAGTAAGGCCTACTACCCTTCGGTCAGCG|AAATGCCCTACCGAACACTTGATCATCCCA
AAGGCCTACTACCCGAAATGCCCTACCGAA|CGGGCGAGTGAGACAAACGCGCGCAAGAAT
AAGTCATGGCTCACCAAAGGTTACGTGCCC|TTCCAGAAACGTCAGCACATAGCGACAGAA
TAAGGCCTACTACCCATTCGTTAGGGGTCA|GATAATGCGCCTGTACCAGGTGCACATATG
TCCATACTAACCTCAAAGGAAGAGAAAGGG|GCTCCTAGTCGAGCAGGAAGACTTCTACGG
CTTTCCTGTCGGACCCTTCTAAAGCGGCTG|CTCGAATTTTGTAACCCTGGTCAGCGCACG
CAGGTACTGTGTGATACCGGTCAGCGCACG|CTGTAGCTTACACACAAGCTTGATTTATAG
TCAGCGCACGGAGTAAGGCCTACTACCCCT|AACATATCGTCGTACGAGATAATCACGCAA
AGGCCTACTACCCATTCGTTAGGGGTCAAT|TAATGCGCCTGTACCAGGTGCACATATGGA
GGTTACGTGCCCATCAGTCACACCATGCAT|ATAGCGACAGAAAAGGTTACCTACTTCAAT
TCTATGTCATTAGGGTCAGCGCACGGAGTA|TAAGGCCTACTACCCGCTGGGGAGGTCAGC
CCATACAGGAGCGCCACGCGGGATGCTATG|AAAGGAAGAGAAAGGGATAGCGGTCAGCGC
TTTTATCTTCAGCAGCCCTGAGCCGGTACC|GGTCAGCGCACGGAGTAAGGCCTACTACCC
AGGCCTACTACCCGGAAAGAGCTGGAAGAA|CAGCGCACGGAGTAAGGCCTACTACCCCTT
ACGGAGTAAGGCCTACTACCCGGAAAGAGC|TAGCTGGTCAGCGCACGGAGTAAGGCCTAC
GGGCTCCTAGTCGAGCAGGAAGACTTCTAC|GTTGTTCGGCAGAGGTGGTCCCGGGTCAGC
CTACCCGAAATGCCCTACCGAACACTTGAT|TGAGACAAACGCGCGCAAGAATTCGGGACG
ACGGAGTAAGGCCTACTACCCGGCTGGTCA|AGGTCAGCGCACGGAGTAAGGCCTACTACC
ACCGCAGGTACTGTGTGATACCGGTCAGCG|ACCACTGTAGCTTACACACAAGCTTGATTT
TAAGGCCTACTACCCATACCCCGTGAATTG|GGAGTAAGGCCTACTACCCGGCTGGTCAGC
AAGCTAGGGTCTATTTCTCGGCCGGTGATT|CCTACTACCCATACCCCGTGAATTGAAAGC
CGGAGTAAGGTCAGCGCACGGAGTAAGGCC|CCGGAAAGAGCTGGAAGAAGTCATGGCTCA
AGACCTCCAATACCACTGTAGCTTACACAC|ATAGCAAACGCTTAAACTCTCCGGTAGAAC
AAGGAAGAGAAAGGGATAGCGGTCAGCGCA|GGAAGACTTCTACGGGGGGAGCTAGTGGCT
ACCCCTTCCAGAAACGTCAGCACATAGCGA|ACGCAATTGTTCACCAGTATCACTCAGCGC
CTGTTCGGTGGTCATGGCCGACGTTTAACC|GGAGTAAGGCCTACTACCCCACTCCATACT
ACCCTGGTCAGCGCACGGAGTAAGGTCAGC|AGTAAGGCCTACTACCCGGAAAGAGCTGGA
GCGCACGGAGTAAGGCCTACTACCCCACTC|CATTCGTTAGGGGTCAATCCAGGCGCGGGC
AGCGCACGGAGTAAGGCCTACTACCCCCTC|CGCACGGAGTAAGGCCTACTACCCTTCGGT
TAAGGCCTACTACCCGGAAAGAGCTGGAAG|GTCAGCGCACGGAGTAAGGCCTACTACCCC
CATGGCCGACGTTTAACCGAGTGTCCATAC|ACTACCCCACTCCATACTAACCTCAAAGGA
CTCTCGAGGAGCAAGTTCCGAGTCACACAC|GCCGGTACCACGGCCGAGCTCTTTCCTGTC
CACGGAGTAAGGCCTACTACCCGATGCATC|GACGCTATAATACCGCAGGTACTGTGTGAT
ATACCACTGTAGCTTACACACAAGCTTGAT|GCTTAAACTCTCCGGTAGAACCCGTCCTTT
GGTTAGGAAACGTGTAGTCGACGCTATAAT|AGTCACACCATGCATGCCTAGACCTCCAAT
AGTGGCTCCATTAGGGTCAGCGCACGGAGT|AGGCCTACTACCCGTCAGCGCACGGAGTAA
CCAGGTGCACATATGGAAGAGCACAGTTGT|CCTACTACCCGAGGAAACTCTCGAGGAGCA
TACCCATTCGTTAGGGGTCAATCCAGGCGC|CTGTACCAGGTGCACATATGGAAGAGCACA
GCAGGTACTGTGTGATACCGGTCAGCGCAC|ACTGTAGCTTACACACAAGCTTGATTTATA
GTCAGCGCACGGAGTAAGGCCTACTACCCC|CAGCGCACGGAGTAAGGCCTACTACCCTTC
AAGGTCAGCGCACGGAGTAAGGCCTACTAC|AGAGCTGGAAGAAGTCATGGCTCACCAAAG
TTTTCTTAGGGACGGATTGATTCTCAGACG|GCTGTTCGGTGGTCATGGCCGACGTTTAAC
TGTCATGGTCAGCGCACGGAGTAAGGCCTA|GGAAACGTGTAGTCGACGCTATAATACCGC
ACCACTGTAGCTTACACACAAGCTTGATTT|TTAAACTCTCCGGTAGAACCCGTCCTTTAT
CTACCCGAGGAAACTCTCGAGGAGCAAGTT|TCAGCAGCCCTGAGCCGGTACCACGGCCGA
AAAGGTACGGAAGGTCGGTCAGCGCACGGA|GACGGTGTCTATGTCATTAGGGTCAGCGCA
GGTCCCGGGTCAGCGCACGGAGTAAGGCCT|ACACACTTTGGTTATGGGTCAGCGCACGGA
AGACGTTATTACACTCGTGACTTGGTTTCT|TTAACCGAGTGTCCATACAGGAGCGCCACG
GCCTAGACCTCCAATACCACTGTAGCTTAC|TGTGATAGCAAACGCTTAAACTCTCCGGTA
GTGATTTTCTTAGGGACGGATTGATTCTCA|GAAAGCTGTTCGGTGGTCATGGCCGACGTT
CTCACCAAAGGTTACGTGCCCATCAGTCAC|CGTCAGCACATAGCGACAGAAAAGGTTACC
CTTACACACAAGCTTGATTTATAGCTGGTC|CGGTAGAACCCGTCCTTTATGTACAGCAAA
TCCTAGTCGAGCAGGAAGACTTCTACGGGG|TTCGGCAGAGGTGGTCCCGGGTCAGCGCAC
ATGGTCAGCGCACGGAGTAAGGCCTACTAC|ACGTGTAGTCGACGCTATAATACCGCAGGT
GTGTCTATGTCATTAGGGTCAGCGCACGGA|GAGTAAGGCCTACTACCCGCTGGGGAGGTC
TGCGCCTGTACCAGGTGCACATATGGAAGA|CGGAGTAAGGCCTACTACCCGAGGAAACTC
CTACTACCCGGCTGGTCAGCGCACGGAGTA|GGAGTAAGGCCTACTACCCATTCGTTAGGG
CTACCCATACCCCGTGAATTGAAAGCTGTT|CCTACTACCCGGCTGGTCAGCGCACGGAGT
ACTCCATACTAACCTCAAAGGAAGAGAAAG|GGGCTCCTAGTCGAGCAGGAAGACTTCTAC
ACTGTAGCTTACACACAAGCTTGATTTATA|AACTCTCCGGTAGAACCCGTCCTTTATGTA
CACTCGTGACTTGGTTTCTCATCCCTATTC|TCCATACAGGAGCGCCACGCGGGATGCTAT
AGCTGGTCAGCGCACGGAGTAAGGCCTACT|ACAGCAAACATATCGTCGTACGAGATAATC
CCCCGTGAATTGAAAGCTGTTCGGTGGTCA|CGGCTGGTCAGCGCACGGAGTAAGGCCTAC
GGTCAGCGCACGGAGTAAGGCCTACTACCC|TTAGGGTCAGCGCACGGAGTAAGGCCTACT
ATCCCACATCGCGATTTTATCTTCAGCAGC|ACGCCATATGTCATGGTCAGCGCACGGAGT
GGCTCCTAGTCGAGCAGGAAGACTTCTACG|TTGTTCGGCAGAGGTGGTCCCGGGTCAGCG
AAGACTTCTACGGGGGGAGCTAGTGGCTCC|CCCGGGTCAGCGCACGGAGTAAGGCCTACT
GATTCTCAGACGTTATTACACTCGTGACTT|CCGACGTTTAACCGAGTGTCCATACAGGAG
CGGAAAGAGCTGGAAGAAGTCATGGCTCAC|TAAGGCCTACTACCCCTTCCAGAAACGTCA
AAGAAGTCATGGCTCACCAAAGGTTACGTG|CCCTTCCAGAAACGTCAGCACATAGCGACA
CGGAGTAAGGCCTACTACCCATTCGTTAGG|CTCAAGATAATGCGCCTGTACCAGGTGCAC
GAGTAAGGCCTACTACCCGAGGAAACTCTC|GCGATTTTATCTTCAGCAGCCCTGAGCCGG
AAACGTCAGCACATAGCGACAGAAAAGGTT|CACCAGTATCACTCAGCGCTTCCATCTACG
TTGTTCGGCAGAGGTGGTCCCGGGTCAGCG|AGCAAGTTCCGAGTCACACACTTTGGTTAT
AAAGGAAGAGAAAGGGATAGCGGTCAGCGC|AGGAAGACTTCTACGGGGGGAGCTAGTGGC
GTGACTTGGTTTCTCATCCCTATTCAAAGG|ACAGGAGCGCCACGCGGGATGCTATGACGG
TGTACCAGGTGCACATATGGAAGAGCACAG|AAGGCCTACTACCCGAGGAAACTCTCGAGG
AACCCTGGTCAGCGCACGGAGTAAGGTCAG|GAGTAAGGCCTACTACCCGGAAAGAGCTGG
GGCGAGTGAGACAAACGCGCGCAAGAATTC|TCAGCGCACGGAGTAAGGCCTACTACCCGG
TACCACGGCCGAGCTCTTTCCTGTCGGACC|ACCCGATGCATCTAGCTCGAATTTTGTAAC
TGGTCAGCGCACGGAGTAAGGCCTACTACC|GCAAACATATCGTCGTACGAGATAATCACG
TCCAATACCACTGTAGCTTACACACAAGCT|AAACGCTTAAACTCTCCGGTAGAACCCGTC
ACTACCCGATGCATCTAGCTCGAATTTTGT|CAGGTACTGTGTGATACCGGTCAGCGCACG
TCCAGAAACGTCAGCACATAGCGACAGAAA|TTGTTCACCAGTATCACTCAGCGCTTCCAT
GGAAGACTTCTACGGGGGGAGCTAGTGGCT|GTCCCGGGTCAGCGCACGGAGTAAGGCCTA
CCCGGTTAGGAAACGTGTAGTCGACGCTAT|ATCAGTCACACCATGCATGCCTAGACCTCC
GGCCTACTACCCCCTCAAGATAATGCGCCT|CCTACTACCCTTCGGTCAGCGCACGGAGTA
GGTGTCTATGTCATTAGGGTCAGCGCACGG|GGAGTAAGGCCTACTACCCGCTGGGGAGGT
CAGCGCACGGAGTAAGGCCTACTACCCATA|GGGTCAGCGCACGGAGTAAGGCCTACTACC
GTCATGGCTCACCAAAGGTTACGTGCCCAT|CCAGAAACGTCAGCACATAGCGACAGAAAA
ACTACCCATTCGTTAGGGGTCAATCCAGGC|GCCTGTACCAGGTGCACATATGGAAGAGCA
CCGCAGGTACTGTGTGATACCGGTCAGCGC|CCACTGTAGCTTACACACAAGCTTGATTTA
TACCGAACACTTGATCATCCCACATCGCGA|CAAGAATTCGGGACGCACGCCATATGTCAT
AGCAGGAAGACTTCTACGGGGGGAGCTAGT|GGTGGTCCCGGGTCAGCGCACGGAGTAAGG
AGTCATGGCTCACCAAAGGTTACGTGCCCA|TCCAGAAACGTCAGCACATAGCGACAGAAA
CCGGTGATTTTCTTAGGGACGGATTGATTC|ATTGAAAGCTGTTCGGTGGTCATGGCCGAC
GCCTACTACCCTTCGGTCAGCGCACGGAGT|TACCGAACACTTGATCATCCCACATCGCGA
GGTCAGCGCACGGAGTAAGGCCTACTACCC|TCATCCCACATCGCGATTTTATCTTCAGCA
AATTCGGGACGCACGCCATATGTCATGGTC|CCCGGCCTACTACCCGGTTAGGAAACGTGT
ACTTGGTTTCTCATCCCTATTCAAAGGTAC|GGAGCGCCACGCGGGATGCTATGACGGTGT
TTGATCATCCCACATCGCGATTTTATCTTC|GGACGCACGCCATATGTCATGGTCAGCGCA
TAGGGTCTATTTCTCGGCCGGTGATTTTCT|CTACCCATACCCCGTGAATTGAAAGCTGTT
TACCCATACCCCGTGAATTGAAAGCTGTTC|CTACTACCCGGCTGGTCAGCGCACGGAGTA
CTACCCTTCGGTCAGCGCACGGAGTAAGGC|AACACTTGATCATCCCACATCGCGATTTTA
GTCTATGTCATTAGGGTCAGCGCACGGAGT|GTAAGGCCTACTACCCGCTGGGGAGGTCAG
CATCCCTATTCAAAGGTACGGAAGGTCGGT|CGGGATGCTATGACGGTGTCTATGTCATTA
CACTTTGGTTATGGGTCAGCGCACGGAGTA|GTCGGACCCTTCTAAAGCGGCTGATAGTCC
AGGCCTACTACCCGATGCATCTAGCTCGAA|ATACCGCAGGTACTGTGTGATACCGGTCAG
GGCCGAGCTCTTTCCTGTCGGACCCTTCTA|TGCATCTAGCTCGAATTTTGTAACCCTGGT
CTATTCAAAGGTACGGAAGGTCGGTCAGCG|TGCTATGACGGTGTCTATGTCATTAGGGTC
AAGGCCTACTACCCGGCCTACTACCCGGTT|GGCTCACCAAAGGTTACGTGCCCATCAGTC
CCTCAAAGGAAGAGAAAGGGATAGCGGTCA|GAGCAGGAAGACTTCTACGGGGGGAGCTAG
TTCCGAGTCACACACTTTGGTTATGGGTCA|GAGCTCTTTCCTGTCGGACCCTTCTAAAGC
AGCGCACGGAGTAAGGCCTACTACCCGAAA|CGGCTGATAGTCCGGGCGAGTGAGACAAAC
GTAAGGCCTACTACCCCTTCCAGAAACGTC|TACGAGATAATCACGCAATTGTTCACCAGT
CCACATCGCGATTTTATCTTCAGCAGCCCT|CCATATGTCATGGTCAGCGCACGGAGTAAG
CGTGACTTGGTTTCTCATCCCTATTCAAAG|TACAGGAGCGCCACGCGGGATGCTATGACG
GTCAGCGCACGGAGTAAGGCCTACTACCCG|TGTAGTCGACGCTATAATACCGCAGGTACT
TGGAAGAGCACAGTTGTTCGGCAGAGGTGG|GAAACTCTCGAGGAGCAAGTTCCGAGTCAC
CCTGTACCAGGTGCACATATGGAAGAGCAC|GTAAGGCCTACTACCCGAGGAAACTCTCGA
GCGAGTGAGACAAACGCGCGCAAGAATTCG|CAGCGCACGGAGTAAGGCCTACTACCCGGC
CTACCCGATGCATCTAGCTCGAATTTTGTA|AGGTACTGTGTGATACCGGTCAGCGCACGG
TTCGGTGGTCATGGCCGACGTTTAACCGAG|GTAAGGCCTACTACCCCACTCCATACTAAC
TACTACCCCTTCCAGAAACGTCAGCACATA|AATCACGCAATTGTTCACCAGTATCACTCA
ACCCCACTCCATACTAACCTCAAAGGAAGA|GGCGCGGGCTCCTAGTCGAGCAGGAAGACT
CAGCGCACGGAGTAAGGCCTACTACCCGAA|GCGGCTGATAGTCCGGGCGAGTGAGACAAA
CCGAGCTCTTTCCTGTCGGACCCTTCTAAA|CATCTAGCTCGAATTTTGTAACCCTGGTCA
ACACAAGCTTGATTTATAGCTGGTCAGCGC|GAACCCGTCCTTTATGTACAGCAAACATAT
TTCTCAGACGTTATTACACTCGTGACTTGG|GACGTTTAACCGAGTGTCCATACAGGAGCG
AGGGTCTATTTCTCGGCCGGTGATTTTCTT|TACCCATACCCCGTGAATTGAAAGCTGTTC
GTCAGCACATAGCGACAGAAAAGGTTACCT|AGTATCACTCAGCGCTTCCATCTACGACTG
AGTAAGGCCTACTACCCTTCGGTCAGCGCA|ATGCCCTACCGAACACTTGATCATCCCACA
ATGTCATTAGGGTCAGCGCACGGAGTAAGG|GGCCTACTACCCGCTGGGGAGGTCAGCGCA
TCATGGCTCACCAAAGGTTACGTGCCCATC|CAGAAACGTCAGCACATAGCGACAGAAAAG
ACAGTTGTTCGGCAGAGGTGGTCCCGGGTC|GAGGAGCAAGTTCCGAGTCACACACTTTGG
TATGGAAGAGCACAGTTGTTCGGCAGAGGT|AGGAAACTCTCGAGGAGCAAGTTCCGAGTC
ATGTCATGGTCAGCGCACGGAGTAAGGCCT|AGGAAACGTGTAGTCGACGCTATAATACCG
TAGGAAACGTGTAGTCGACGCTATAATACC|CACACCATGCATGCCTAGACCTCCAATACC
CACGGAGTAAGGCCTACTACCCGAGGAAAC|CATCGCGATTTTATCTTCAGCAGCCCTGAG
TATTACACTCGTGACTTGGTTTCTCATCCC|GAGTGTCCATACAGGAGCGCCACGCGGGAT
ACCCCGTGAATTGAAAGCTGTTCGGTGGTC|CCGGCTGGTCAGCGCACGGAGTAAGGCCTA
TTATGGGTCAGCGCACGGAGTAAGGCCTAC|CTTCTAAAGCGGCTGATAGTCCGGGCGAGT
CCTCCAATACCACTGTAGCTTACACACAAG|GCAAACGCTTAAACTCTCCGGTAGAACCCG
CAGAAACGTCAGCACATAGCGACAGAAAAG|GTTCACCAGTATCACTCAGCGCTTCCATCT
GGCCTACTACCCGGAAAGAGCTGGAAGAAG|AGCGCACGGAGTAAGGCCTACTACCCCTTC
CTCAAAGGAAGAGAAAGGGATAGCGGTCAG|AGCAGGAAGACTTCTACGGGGGGAGCTAGT
TTATAGCTGGTCAGCGCACGGAGTAAGGCC|ATGTACAGCAAACATATCGTCGTACGAGAT
TGTGATACCGGTCAGCGCACGGAGTAAGGC|ACACACAAGCTTGATTTATAGCTGGTCAGC
TCGGTCAGCGCACGGAGTAAGGCCTACTAC|CATTAGGGTCAGCGCACGGAGTAAGGCCTA
GCGCACGGAGTAAGGCCTACTACCCGTCAG|TATGGGTCAGCGCACGGAGTAAGGCCTACT
GAGCACAGTTGTTCGGCAGAGGTGGTCCCG|TCTCGAGGAGCAAGTTCCGAGTCACACACT
CTCATCCCTATTCAAAGGTACGGAAGGTCG|CGCGGGATGCTATGACGGTGTCTATGTCAT
GTAAGGCCTACTACCCGTCAGCGCACGGAG|GCGCACGGAGTAAGGCCTACTACCCGAAAT
CGGAGTAAGGCCTACTACCCGAAATGCCCT|ATAGTCCGGGCGAGTGAGACAAACGCGCGC
TGGTCAGCGCACGGAGTAAGGTCAGCGCAC|AGGCCTACTACCCGGAAAGAGCTGGAAGAA
ATGCGCCTGTACCAGGTGCACATATGGAAG|ACGGAGTAAGGCCTACTACCCGAGGAAACT
CCACTCCATACTAACCTCAAAGGAAGAGAA|GCGGGCTCCTAGTCGAGCAGGAAGACTTCT
GTACCAGGTGCACATATGGAAGAGCACAGT|AGGCCTACTACCCGAGGAAACTCTCGAGGA
GCGGCTGATAGTCCGGGCGAGTGAGACAAA|GCGCACGGAGTAAGGTCAGCGCACGGAGTA
CACGGAGTAAGGCCTACTACCCGGCTGGTC|GAGGTCAGCGCACGGAGTAAGGCCTACTAC
TAGCTTACACACAAGCTTGATTTATAGCTG|CTCCGGTAGAACCCGTCCTTTATGTACAGC
ACGCGCGCAAGAATTCGGGACGCACGCCAT|AAGGCCTACTACCCGGCCTACTACCCGGTT
AGGTTACGTGCCCATCAGTCACACCATGCA|CATAGCGACAGAAAAGGTTACCTACTTCAA
GCACGGAGTAAGGCCTACTACCCGGCTGGT|GGAGGTCAGCGCACGGAGTAAGGCCTACTA
CGCACGGAGTAAGGCCTACTACCCGAAATG|GCTGATAGTCCGGGCGAGTGAGACAAACGC
CACGGAGTAAGGCCTACTACCCGTCAGCGC|GGGTCAGCGCACGGAGTAAGGCCTACTACC
CATACCCCGTGAATTGAAAGCTGTTCGGTG|TACCCGGCTGGTCAGCGCACGGAGTAAGGC
CGGAGTAAGGCCTACTACCCGGAAAGAGCT|AGCTGGTCAGCGCACGGAGTAAGGCCTACT
TTAGGGACGGATTGATTCTCAGACGTTATT|TCGGTGGTCATGGCCGACGTTTAACCGAGT
AGGCCTACTACCCGTCAGCGCACGGAGTAA|CACGGAGTAAGGCCTACTACCCGAAATGCC
GCCTACTACCCGGCCTACTACCCGGTTAGG|TCACCAAAGGTTACGTGCCCATCAGTCACA
GGTCATGGCCGACGTTTAACCGAGTGTCCA|CCTACTACCCCACTCCATACTAACCTCAAA
GGTCAGCGCACGGAGTAAGGCCTACTACCC|TTGGTTATGGGTCAGCGCACGGAGTAAGGC
CTTCCAGAAACGTCAGCACATAGCGACAGA|AATTGTTCACCAGTATCACTCAGCGCTTCC
GGGTCAATCCAGGCGCGGGCTCCTAGTCGA|CATATGGAAGAGCACAGTTGTTCGGCAGAG
GAGTAAGGCCTACTACCCGTCAGCGCACGG|CAGCGCACGGAGTAAGGCCTACTACCCGAA
GCACAGTTGTTCGGCAGAGGTGGTCCCGGG|TCGAGGAGCAAGTTCCGAGTCACACACTTT
AGTAAGGCCTACTACCCCACTCCATACTAA|AGGGGTCAATCCAGGCGCGGGCTCCTAGTC
GGCCTACTACCCGGCTGGTCAGCGCACGGA|CACGGAGTAAGGCCTACTACCCATTCGTTA
ACGGAGTAAGGCCTACTACCCATACCCCGT|GCGCACGGAGTAAGGCCTACTACCCGGCTG
AACGCGCGCAAGAATTCGGGACGCACGCCA|TAAGGCCTACTACCCGGCCTACTACCCGGT
GGTCAGCGCACGGAGTAAGGCCTACTACCC|CTTGATTTATAGCTGGTCAGCGCACGGAGT
ACCGGTCAGCGCACGGAGTAAGGCCTACTA|AAGCTTGATTTATAGCTGGTCAGCGCACGG
AGCTAGTGGCTCCATTAGGGTCAGCGCACG|AGTAAGGCCTACTACCCGTCAGCGCACGGA
ATTCTCAGACGTTATTACACTCGTGACTTG|CGACGTTTAACCGAGTGTCCATACAGGAGC
GCGGTCAGCGCACGGAGTAAGGCCTACTAC|GAGCTAGTGGCTCCATTAGGGTCAGCGCAC
GTAACCCTGGTCAGCGCACGGAGTAAGGTC|CGGAGTAAGGCCTACTACCCGGAAAGAGCT
CCGTCAGCGCACGGAGTAAGGCCTACTACC|GCCTACTACCCGAAATGCCCTACCGAACAC
TACTACCCATACCCCGTGAATTGAAAGCTG|GGCCTACTACCCGGCTGGTCAGCGCACGGA
CTACCCGCTGGGGAGGTCAGCGCACGGAGT|GCACGGAGTAAGGCCTACTACCCCCTCAAG
CCCACTCCATACTAACCTCAAAGGAAGAGA|CGCGGGCTCCTAGTCGAGCAGGAAGACTTC
AAACGCGCGCAAGAATTCGGGACGCACGCC|GTAAGGCCTACTACCCGGCCTACTACCCGG
AGCCCTGAGCCGGTACCACGGCCGAGCTCT|AGTAAGGCCTACTACCCGATGCATCTAGCT
AGGCCTACTACCCGGCCTACTACCCGGTTA|GCTCACCAAAGGTTACGTGCCCATCAGTCA
AGTAAGGCCTACTACCCGATGCATCTAGCT|TATAATACCGCAGGTACTGTGTGATACCGG
ACGGTGTCTATGTCATTAGGGTCAGCGCAC|ACGGAGTAAGGCCTACTACCCGCTGGGGAG
TCAGCGCACGGAGTAAGGCCTACTACCCGA|ATCCCACATCGCGATTTTATCTTCAGCAGC
AAATGCCCTACCGAACACTTGATCATCCCA|AACGCGCGCAAGAATTCGGGACGCACGCCA
GGTGCACATATGGAAGAGCACAGTTGTTCG|ACTACCCGAGGAAACTCTCGAGGAGCAAGT
GCACGGAGTAAGGCCTACTACCCGGCCTAC|AGAAGTCATGGCTCACCAAAGGTTACGTGC
GCCCTACCGAACACTTGATCATCCCACATC|CGCGCAAGAATTCGGGACGCACGCCATATG
AGCCGGTACCACGGCCGAGCTCTTTCCTGT|CCTACTACCCGATGCATCTAGCTCGAATTT
GTTTAACCGAGTGTCCATACAGGAGCGCCA|TCCATACTAACCTCAAAGGAAGAGAAAGGG
CCGACGTTTAACCGAGTGTCCATACAGGAG|CCCACTCCATACTAACCTCAAAGGAAGAGA
CCTACTACCCGGCTGGTCAGCGCACGGAGT|CGGAGTAAGGCCTACTACCCATTCGTTAGG
GCACGGAGTAAGGCCTACTACCCGCTGGGG|GCTCCATTAGGGTCAGCGCACGGAGTAAGG
AGTCACACCATGCATGCCTAGACCTCCAAT|GTTACCTACTTCAATTGTGATAGCAAACGC
CCGGCCTACTACCCGGTTAGGAAACGTGTA|GTTACGTGCCCATCAGTCACACCATGCATG
CCCTATTCAAAGGTACGGAAGGTCGGTCAG|GATGCTATGACGGTGTCTATGTCATTAGGG
GGGCGAGTGAGACAAACGCGCGCAAGAATT|GTCAGCGCACGGAGTAAGGCCTACTACCCG
CTCAGACGTTATTACACTCGTGACTTGGTT|CGTTTAACCGAGTGTCCATACAGGAGCGCC
CTACTACCCGCTGGGGAGGTCAGCGCACGG|AGCGCACGGAGTAAGGCCTACTACCCCCTC
TTCTCATCCCTATTCAAAGGTACGGAAGGT|CACGCGGGATGCTATGACGGTGTCTATGTC
ACGGAGTAAGGCCTACTACCCGAAATGCCC|GATAGTCCGGGCGAGTGAGACAAACGCGCG
GGGACGGATTGATTCTCAGACGTTATTACA|GTGGTCATGGCCGACGTTTAACCGAGTGTC
TCTCAGACGTTATTACACTCGTGACTTGGT|ACGTTTAACCGAGTGTCCATACAGGAGCGC
AGAAAGGGATAGCGGTCAGCGCACGGAGTA|TTCTACGGGGGGAGCTAGTGGCTCCATTAG
TCCGAGTCACACACTTTGGTTATGGGTCAG|AGCTCTTTCCTGTCGGACCCTTCTAAAGCG
AGCGCACGGAGTAAGGCCTACTACCCGGCT|TGGGGAGGTCAGCGCACGGAGTAAGGCCTA
GAAGTCATGGCTCACCAAAGGTTACGTGCC|CTTCCAGAAACGTCAGCACATAGCGACAGA
AGTCACACACTTTGGTTATGGGTCAGCGCA|CTTTCCTGTCGGACCCTTCTAAAGCGGCTG
TGGGTCAGCGCACGGAGTAAGGCCTACTAC|CTAAAGCGGCTGATAGTCCGGGCGAGTGAG
TAGGGACGGATTGATTCTCAGACGTTATTA|CGGTGGTCATGGCCGACGTTTAACCGAGTG
TTCAAAGGTACGGAAGGTCGGTCAGCGCAC|TATGACGGTGTCTATGTCATTAGGGTCAGC
TATCTTCAGCAGCCCTGAGCCGGTACCACG|CAGCGCACGGAGTAAGGCCTACTACCCGAT
ACAGGAGCGCCACGCGGGATGCTATGACGG|GAAGAGAAAGGGATAGCGGTCAGCGCACGG
CAAAGGTACGGAAGGTCGGTCAGCGCACGG|TGACGGTGTCTATGTCATTAGGGTCAGCGC
GAGTAAGGCCTACTACCCGGCTGGTCAGCG|TCAGCGCACGGAGTAAGGCCTACTACCCAT
ACCCGGAAAGAGCTGGAAGAAGTCATGGCT|GAGTAAGGCCTACTACCCCTTCCAGAAACG
TCACACACTTTGGTTATGGGTCAGCGCACG|TTCCTGTCGGACCCTTCTAAAGCGGCTGAT
ACCCGCTGGGGAGGTCAGCGCACGGAGTAA|ACGGAGTAAGGCCTACTACCCCCTCAAGAT
AGTCCGGGCGAGTGAGACAAACGCGCGCAA|GTAAGGTCAGCGCACGGAGTAAGGCCTACT
ATGGCCGACGTTTAACCGAGTGTCCATACA|CTACCCCACTCCATACTAACCTCAAAGGAA
CAGGAAGACTTCTACGGGGGGAGCTAGTGG|TGGTCCCGGGTCAGCGCACGGAGTAAGGCC
ATTTTGTAACCCTGGTCAGCGCACGGAGTA|GCGCACGGAGTAAGGCCTACTACCCGGAAA
GAGACAAACGCGCGCAAGAATTCGGGACGC|ACGGAGTAAGGCCTACTACCCGGCCTACTA
GCACGGAGTAAGGCCTACTACCCATTCGTT|CCCCTCAAGATAATGCGCCTGTACCAGGTG
AAGAGCACAGTTGTTCGGCAGAGGTGGTCC|ACTCTCGAGGAGCAAGTTCCGAGTCACACA
TACTACCCCCTCAAGATAATGCGCCTGTAC|CTACCCTTCGGTCAGCGCACGGAGTAAGGC
CGAAATGCCCTACCGAACACTTGATCATCC|CAAACGCGCGCAAGAATTCGGGACGCACGC
AGCTCTTTCCTGTCGGACCCTTCTAAAGCG|CTAGCTCGAATTTTGTAACCCTGGTCAGCG
ATAGCGGTCAGCGCACGGAGTAAGGCCTAC|GGGGAGCTAGTGGCTCCATTAGGGTCAGCG
GAGCAAGTTCCGAGTCACACACTTTGGTTA|CACGGCCGAGCTCTTTCCTGTCGGACCCTT
CAGCGCACGGAGTAAGGCCTACTACCCCTT|ACATATCGTCGTACGAGATAATCACGCAAT
CGCGGGATGCTATGACGGTGTCTATGTCAT|ATAGCGGTCAGCGCACGGAGTAAGGCCTAC
GCTATGACGGTGTCTATGTCATTAGGGTCA|CAGCGCACGGAGTAAGGCCTACTACCCGCT
CGGAGTAAGGCCTACTACCCATACCCCGTG|CGCACGGAGTAAGGCCTACTACCCGGCTGG
GTAAGGCCTACTACCCGAGGAAACTCTCGA|GATTTTATCTTCAGCAGCCCTGAGCCGGTA
CGAGCTCTTTCCTGTCGGACCCTTCTAAAG|ATCTAGCTCGAATTTTGTAACCCTGGTCAG
CATATGTCATGGTCAGCGCACGGAGTAAGG|GTTAGGAAACGTGTAGTCGACGCTATAATA
AGGTCAGCGCACGGAGTAAGGCCTACTACC|GAGCTGGAAGAAGTCATGGCTCACCAAAGG
CGTTAGGGGTCAATCCAGGCGCGGGCTCCT|GGTGCACATATGGAAGAGCACAGTTGTTCG
TAGTCGAGCAGGAAGACTTCTACGGGGGGA|GGCAGAGGTGGTCCCGGGTCAGCGCACGGA
GGAAGGTCGGTCAGCGCACGGAGTAAGGCC|CTATGTCATTAGGGTCAGCGCACGGAGTAA
TTACACACAAGCTTGATTTATAGCTGGTCA|GGTAGAACCCGTCCTTTATGTACAGCAAAC
CATTAGGGTCAGCGCACGGAGTAAGGCCTA|TACTACCCGCTGGGGAGGTCAGCGCACGGA
AAGGCCTACTACCCATACCCCGTGAATTGA|GAGTAAGGCCTACTACCCGGCTGGTCAGCG
GGAAGAAGTCATGGCTCACCAAAGGTTACG|ACCCCTTCCAGAAACGTCAGCACATAGCGA
CCCTTCGGTCAGCGCACGGAGTAAGGCCTA|ACTTGATCATCCCACATCGCGATTTTATCT
GACCCTTCTAAAGCGGCTGATAGTCCGGGC|TAACCCTGGTCAGCGCACGGAGTAAGGTCA
GTCCATACAGGAGCGCCACGCGGGATGCTA|TCAAAGGAAGAGAAAGGGATAGCGGTCAGC
GTAAGGCCTACTACCCGGCTGGTCAGCGCA|AGCGCACGGAGTAAGGCCTACTACCCATTC
CCACGCGGGATGCTATGACGGTGTCTATGT|GGGATAGCGGTCAGCGCACGGAGTAAGGCC
AAAGCTAGGGTCTATTTCTCGGCCGGTGAT|GCCTACTACCCATACCCCGTGAATTGAAAG
CGACGTTTAACCGAGTGTCCATACAGGAGC|CCACTCCATACTAACCTCAAAGGAAGAGAA
ACTACCCCCTCAAGATAATGCGCCTGTACC|TACCCTTCGGTCAGCGCACGGAGTAAGGCC
CAGCGCACGGAGTAAGGCCTACTACCCGAT|TAGTCGACGCTATAATACCGCAGGTACTGT
CAGGAGCGCCACGCGGGATGCTATGACGGT|AAGAGAAAGGGATAGCGGTCAGCGCACGGA
CACTTGATCATCCCACATCGCGATTTTATC|TCGGGACGCACGCCATATGTCATGGTCAGC
CCTACCGAACACTTGATCATCCCACATCGC|CGCAAGAATTCGGGACGCACGCCATATGTC
CCGGTCAGCGCACGGAGTAAGGCCTACTAC|AGCTTGATTTATAGCTGGTCAGCGCACGGA
TACTACCCGGAAAGAGCTGGAAGAAGTCAT|CACGGAGTAAGGCCTACTACCCCTTCCAGA
CGGAGTAAGGCCTACTACCCCTTCCAGAAA|GTCGTACGAGATAATCACGCAATTGTTCAC
GGCTCACCAAAGGTTACGTGCCCATCAGTC|AACGTCAGCACATAGCGACAGAAAAGGTTA
CCTGGTCAGCGCACGGAGTAAGGTCAGCGC|TAAGGCCTACTACCCGGAAAGAGCTGGAAG
GGAGTAAGGCCTACTACCCCACTCCATACT|TTAGGGGTCAATCCAGGCGCGGGCTCCTAG
CCCGAAATGCCCTACCGAACACTTGATCAT|GACAAACGCGCGCAAGAATTCGGGACGCAC
GAGTGTCCATACAGGAGCGCCACGCGGGAT|AACCTCAAAGGAAGAGAAAGGGATAGCGGT
CGTTTAACCGAGTGTCCATACAGGAGCGCC|CTCCATACTAACCTCAAAGGAAGAGAAAGG
CCCGCTGGGGAGGTCAGCGCACGGAGTAAG|CGGAGTAAGGCCTACTACCCCCTCAAGATA
GAGAAAGGGATAGCGGTCAGCGCACGGAGT|CTTCTACGGGGGGAGCTAGTGGCTCCATTA
GTAAGGCCTACTACCCGAAATGCCCTACCG|TCCGGGCGAGTGAGACAAACGCGCGCAAGA
AGGCCTACTACCCGGCTGGTCAGCGCACGG|GCACGGAGTAAGGCCTACTACCCATTCGTT
AGCGCACGGAGTAAGGCCTACTACCCGTCA|TTATGGGTCAGCGCACGGAGTAAGGCCTAC
TAAGGCCTACTACCCTTCGGTCAGCGCACG|GCCCTACCGAACACTTGATCATCCCACATC
ACACTCGTGACTTGGTTTCTCATCCCTATT|GTCCATACAGGAGCGCCACGCGGGATGCTA
GAAAGAGCTGGAAGAAGTCATGGCTCACCA|AGGCCTACTACCCCTTCCAGAAACGTCAGC
TGTGTGATACCGGTCAGCGCACGGAGTAAG|TTACACACAAGCTTGATTTATAGCTGGTCA
AGTAAGGCCTACTACCCGGAAAGAGCTGGA|TGGTCAGCGCACGGAGTAAGGCCTACTACC
TTCCAGAAACGTCAGCACATAGCGACAGAA|ATTGTTCACCAGTATCACTCAGCGCTTCCA
GGAGTAAGGCCTACTACCCGTCAGCGCACG|TCAGCGCACGGAGTAAGGCCTACTACCCGA
GCGCACGGAGTAAGGTCAGCGCACGGAGTA|ACTACCCGGAAAGAGCTGGAAGAAGTCATG
ACTTGATCATCCCACATCGCGATTTTATCT|CGGGACGCACGCCATATGTCATGGTCAGCG
TGGCCGACGTTTAACCGAGTGTCCATACAG|TACCCCACTCCATACTAACCTCAAAGGAAG
TGACTTGGTTTCTCATCCCTATTCAAAGGT|CAGGAGCGCCACGCGGGATGCTATGACGGT
GGATGCTATGACGGTGTCTATGTCATTAGG|CGGTCAGCGCACGGAGTAAGGCCTACTACC
ACGTTTAACCGAGTGTCCATACAGGAGCGC|ACTCCATACTAACCTCAAAGGAAGAGAAAG
ACGGGGGGAGCTAGTGGCTCCATTAGGGTC|GCGCACGGAGTAAGGCCTACTACCCGTCAG
GAAGGTCGGTCAGCGCACGGAGTAAGGCCT|TATGTCATTAGGGTCAGCGCACGGAGTAAG
AGACAAACGCGCGCAAGAATTCGGGACGCA|CGGAGTAAGGCCTACTACCCGGCCTACTAC
AACACTTGATCATCCCACATCGCGATTTTA|ATTCGGGACGCACGCCATATGTCATGGTCA
TCAGCGCACGGAGTAAGGCCTACTACCCGG|TGATTTATAGCTGGTCAGCGCACGGAGTAA
AGGAGCAAGTTCCGAGTCACACACTTTGGT|ACCACGGCCGAGCTCTTTCCTGTCGGACCC
TTTATAGCTGGTCAGCGCACGGAGTAAGGC|TATGTACAGCAAACATATCGTCGTACGAGA
GCATGCCTAGACCTCCAATACCACTGTAGC|CAATTGTGATAGCAAACGCTTAAACTCTCC
AAGAGAAAGGGATAGCGGTCAGCGCACGGA|GACTTCTACGGGGGGAGCTAGTGGCTCCAT
CTACCCGGAAAGAGCTGGAAGAAGTCATGG|CGGAGTAAGGCCTACTACCCCTTCCAGAAA
CACACACTTTGGTTATGGGTCAGCGCACGG|TCCTGTCGGACCCTTCTAAAGCGGCTGATA
GGTCAGCGCACGGAGTAAGGCCTACTACCC|CTACTACCCCCTCAAGATAATGCGCCTGTA
GGAGTAAGGCCTACTACCCCTTCCAGAAAC|TCGTACGAGATAATCACGCAATTGTTCACC
ATGGCTCACCAAAGGTTACGTGCCCATCAG|GAAACGTCAGCACATAGCGACAGAAAAGGT
ACACACAAGCTTGATTTATAGCTGGTCAGC|TAGAACCCGTCCTTTATGTACAGCAAACAT
GGCCTACTACCCGTCAGCGCACGGAGTAAG|ACGGAGTAAGGCCTACTACCCGAAATGCCC
CCACGGCCGAGCTCTTTCCTGTCGGACCCT|CCGATGCATCTAGCTCGAATTTTGTAACCC
TACCGCAGGTACTGTGTGATACCGGTCAGC|TACCACTGTAGCTTACACACAAGCTTGATT
TACTACCCCACTCCATACTAACCTCAAAGG|TCCAGGCGCGGGCTCCTAGTCGAGCAGGAA
GAATTGAAAGCTGTTCGGTGGTCATGGCCG|GTCAGCGCACGGAGTAAGGCCTACTACCCC
ACGTTATTACACTCGTGACTTGGTTTCTCA|AACCGAGTGTCCATACAGGAGCGCCACGCG
ACCCATTCGTTAGGGGTCAATCCAGGCGCG|TGTACCAGGTGCACATATGGAAGAGCACAG
GTAAGGTCAGCGCACGGAGTAAGGCCTACT|AAAGAGCTGGAAGAAGTCATGGCTCACCAA
CGGCTGATAGTCCGGGCGAGTGAGACAAAC|CGCACGGAGTAAGGTCAGCGCACGGAGTAA
CCCGGGTCAGCGCACGGAGTAAGGCCTACT|CACTTTGGTTATGGGTCAGCGCACGGAGTA
CATATGGAAGAGCACAGTTGTTCGGCAGAG|CGAGGAAACTCTCGAGGAGCAAGTTCCGAG
TACCCGTCAGCGCACGGAGTAAGGCCTACT|AAGGCCTACTACCCGAAATGCCCTACCGAA
AGAGCACAGTTGTTCGGCAGAGGTGGTCCC|CTCTCGAGGAGCAAGTTCCGAGTCACACAC
TACTACCCGATGCATCTAGCTCGAATTTTG|GCAGGTACTGTGTGATACCGGTCAGCGCAC
GAAGAGCACAGTTGTTCGGCAGAGGTGGTC|AACTCTCGAGGAGCAAGTTCCGAGTCACAC
GGAGTAAGGCCTACTACCCGGAAAGAGCTG|GCTGGTCAGCGCACGGAGTAAGGCCTACTA
AAGTTCCGAGTCACACACTTTGGTTATGGG|GCCGAGCTCTTTCCTGTCGGACCCTTCTAA
GGTCAGCGCACGGAGTAAGGCCTACTACCC|GTGTAGTCGACGCTATAATACCGCAGGTAC
CTTCAGCAGCCCTGAGCCGGTACCACGGCC|CGCACGGAGTAAGGCCTACTACCCGATGCA
TCAGCGCACGGAGTAAGGCCTACTACCCGT|GGTTATGGGTCAGCGCACGGAGTAAGGCCT
AGGAAGAGAAAGGGATAGCGGTCAGCGCAC|GAAGACTTCTACGGGGGGAGCTAGTGGCTC
ACGCCATATGTCATGGTCAGCGCACGGAGT|CCCGGTTAGGAAACGTGTAGTCGACGCTAT
ATACCCCGTGAATTGAAAGCTGTTCGGTGG|ACCCGGCTGGTCAGCGCACGGAGTAAGGCC
TCGAGGAGCAAGTTCCGAGTCACACACTTT|GGTACCACGGCCGAGCTCTTTCCTGTCGGA
CCTAGTCGAGCAGGAAGACTTCTACGGGGG|TCGGCAGAGGTGGTCCCGGGTCAGCGCACG
GCATCTAGCTCGAATTTTGTAACCCTGGTC|GTGATACCGGTCAGCGCACGGAGTAAGGCC
GCCGACGTTTAACCGAGTGTCCATACAGGA|CCCCACTCCATACTAACCTCAAAGGAAGAG
GGTCTATTTCTCGGCCGGTGATTTTCTTAG|CCCATACCCCGTGAATTGAAAGCTGTTCGG
AACTCTCGAGGAGCAAGTTCCGAGTCACAC|GAGCCGGTACCACGGCCGAGCTCTTTCCTG
CGTCAGCACATAGCGACAGAAAAGGTTACC|CAGTATCACTCAGCGCTTCCATCTACGACT
TCTAGCTCGAATTTTGTAACCCTGGTCAGC|ATACCGGTCAGCGCACGGAGTAAGGCCTAC
GGGAGGTCAGCGCACGGAGTAAGGCCTACT|AGGCCTACTACCCCCTCAAGATAATGCGCC
GGAGTAAGGCCTACTACCCGAAATGCCCTA|TAGTCCGGGCGAGTGAGACAAACGCGCGCA
TGTTCGGTGGTCATGGCCGACGTTTAACCG|GAGTAAGGCCTACTACCCCACTCCATACTA
AGCGCACGGAGTAAGGCCTACTACCCGGAA|ATTTATAGCTGGTCAGCGCACGGAGTAAGG
ACCAAAGGTTACGTGCCCATCAGTCACACC|CAGCACATAGCGACAGAAAAGGTTACCTAC
ATCAGTCACACCATGCATGCCTAGACCTCC|AAGGTTACCTACTTCAATTGTGATAGCAAA
CCGGGCGAGTGAGACAAACGCGCGCAAGAA|AGGTCAGCGCACGGAGTAAGGCCTACTACC
TCCGGGCGAGTGAGACAAACGCGCGCAAGA|AAGGTCAGCGCACGGAGTAAGGCCTACTAC
CGCACGGAGTAAGGCCTACTACCCCCTCAA|CACGGAGTAAGGCCTACTACCCTTCGGTCA
GGCCTACTACCCGAGGAAACTCTCGAGGAG|TTATCTTCAGCAGCCCTGAGCCGGTACCAC
GAGTGAGACAAACGCGCGCAAGAATTCGGG|GCGCACGGAGTAAGGCCTACTACCCGGCCT
AAGGCCTACTACCCTTCGGTCAGCGCACGG|CCCTACCGAACACTTGATCATCCCACATCG
TTGGTTTCTCATCCCTATTCAAAGGTACGG|AGCGCCACGCGGGATGCTATGACGGTGTCT
TGAAAGCTGTTCGGTGGTCATGGCCGACGT|GCGCACGGAGTAAGGCCTACTACCCCACTC
CATCTAGCTCGAATTTTGTAACCCTGGTCA|TGATACCGGTCAGCGCACGGAGTAAGGCCT
ATTAGGGTCAGCGCACGGAGTAAGGCCTAC|ACCCGTCAGCGCACGGAGTAAGGCCTACTA
GGCCGACGTTTAACCGAGTGTCCATACAGG|ACCCCACTCCATACTAACCTCAAAGGAAGA
CGGAAGGTCGGTCAGCGCACGGAGTAAGGC|TCTATGTCATTAGGGTCAGCGCACGGAGTA
TAGTGGCTCCATTAGGGTCAGCGCACGGAG|AAGGCCTACTACCCGTCAGCGCACGGAGTA
ATACCGCAGGTACTGTGTGATACCGGTCAG|ATACCACTGTAGCTTACACACAAGCTTGAT
TAGACCTCCAATACCACTGTAGCTTACACA|GATAGCAAACGCTTAAACTCTCCGGTAGAA
AGGCCTACTACCCCCTCAAGATAATGCGCC|GCCTACTACCCTTCGGTCAGCGCACGGAGT
ACCCGTCAGCGCACGGAGTAAGGCCTACTA|AGGCCTACTACCCGAAATGCCCTACCGAAC
ACACTTGATCATCCCACATCGCGATTTTAT|TTCGGGACGCACGCCATATGTCATGGTCAG
CCTGAGCCGGTACCACGGCCGAGCTCTTTC|AAGGCCTACTACCCGATGCATCTAGCTCGA
CCTTCTAAAGCGGCTGATAGTCCGGGCGAG|CCCTGGTCAGCGCACGGAGTAAGGTCAGCG
CTTGGTTTCTCATCCCTATTCAAAGGTACG|GAGCGCCACGCGGGATGCTATGACGGTGTC
GATCATCCCACATCGCGATTTTATCTTCAG|ACGCACGCCATATGTCATGGTCAGCGCACG
AGTAAGGCCTACTACCCATTCGTTAGGGGT|AAGATAATGCGCCTGTACCAGGTGCACATA
TACTACCCGGCTGGTCAGCGCACGGAGTAA|GAGTAAGGCCTACTACCCATTCGTTAGGGG
GTCGGACCCTTCTAAAGCGGCTGATAGTCC|TTTGTAACCCTGGTCAGCGCACGGAGTAAG
GCAGAGGTGGTCCCGGGTCAGCGCACGGAG|TCCGAGTCACACACTTTGGTTATGGGTCAG
ACGTGCCCATCAGTCACACCATGCATGCCT|CGACAGAAAAGGTTACCTACTTCAATTGTG
TCACCAAAGGTTACGTGCCCATCAGTCACA|GTCAGCACATAGCGACAGAAAAGGTTACCT
GGATTGATTCTCAGACGTTATTACACTCGT|CATGGCCGACGTTTAACCGAGTGTCCATAC
AGGCCTACTACCCCACTCCATACTAACCTC|GTCAATCCAGGCGCGGGCTCCTAGTCGAGC
TTCAGCAGCCCTGAGCCGGTACCACGGCCG|GCACGGAGTAAGGCCTACTACCCGATGCAT
TTTCCTGTCGGACCCTTCTAAAGCGGCTGA|TCGAATTTTGTAACCCTGGTCAGCGCACGG
GGCTGATAGTCCGGGCGAGTGAGACAAACG|GCACGGAGTAAGGTCAGCGCACGGAGTAAG
CTTGATCATCCCACATCGCGATTTTATCTT|GGGACGCACGCCATATGTCATGGTCAGCGC
GCGCACGGAGTAAGGCCTACTACCCGCTGG|TGGCTCCATTAGGGTCAGCGCACGGAGTAA
ATCATCCCACATCGCGATTTTATCTTCAGC|CGCACGCCATATGTCATGGTCAGCGCACGG
TCATGGCCGACGTTTAACCGAGTGTCCATA|TACTACCCCACTCCATACTAACCTCAAAGG
TACCCGCTGGGGAGGTCAGCGCACGGAGTA|CACGGAGTAAGGCCTACTACCCCCTCAAGA
CGCACGGAGTAAGGCCTACTACCCGTCAGC|ATGGGTCAGCGCACGGAGTAAGGCCTACTA
CGAACACTTGATCATCCCACATCGCGATTT|GAATTCGGGACGCACGCCATATGTCATGGT
TCAGCGCACGGAGTAAGGCCTACTACCCCA|ACCCATTCGTTAGGGGTCAATCCAGGCGCG
GTCAGCGCACGGAGTAAGGCCTACTACCCC|AAACATATCGTCGTACGAGATAATCACGCA
CATTAGGGTCAGCGCACGGAGTAAGGCCTA|TACCCGTCAGCGCACGGAGTAAGGCCTACT
TAAGGCCTACTACCCGATGCATCTAGCTCG|TAATACCGCAGGTACTGTGTGATACCGGTC
GTACGGAAGGTCGGTCAGCGCACGGAGTAA|GTGTCTATGTCATTAGGGTCAGCGCACGGA
CGCTATAATACCGCAGGTACTGTGTGATAC|ACCTCCAATACCACTGTAGCTTACACACAA
CCGAGTCACACACTTTGGTTATGGGTCAGC|GCTCTTTCCTGTCGGACCCTTCTAAAGCGG
ACGTGTAGTCGACGCTATAATACCGCAGGT|ATGCATGCCTAGACCTCCAATACCACTGTA
TGTCCATACAGGAGCGCCACGCGGGATGCT|CTCAAAGGAAGAGAAAGGGATAGCGGTCAG
CCCGGAAAGAGCTGGAAGAAGTCATGGCTC|AGTAAGGCCTACTACCCCTTCCAGAAACGT
TCAGACGTTATTACACTCGTGACTTGGTTT|GTTTAACCGAGTGTCCATACAGGAGCGCCA
AGGGACGGATTGATTCTCAGACGTTATTAC|GGTGGTCATGGCCGACGTTTAACCGAGTGT
CGCCATATGTCATGGTCAGCGCACGGAGTA|CCGGTTAGGAAACGTGTAGTCGACGCTATA
GGAAACTCTCGAGGAGCAAGTTCCGAGTCA|CCTGAGCCGGTACCACGGCCGAGCTCTTTC
GACTTCTACGGGGGGAGCTAGTGGCTCCAT|CGGGTCAGCGCACGGAGTAAGGCCTACTAC
CGCACGGAGTAAGGCCTACTACCCGGCTGG|GGGAGGTCAGCGCACGGAGTAAGGCCTACT
ACTACCCGAGGAAACTCTCGAGGAGCAAGT|TTCAGCAGCCCTGAGCCGGTACCACGGCCG
CTCGGCCGGTGATTTTCTTAGGGACGGATT|CGTGAATTGAAAGCTGTTCGGTGGTCATGG
CACCAAAGGTTACGTGCCCATCAGTCACAC|TCAGCACATAGCGACAGAAAAGGTTACCTA
CGCACGCCATATGTCATGGTCAGCGCACGG|CTACCCGGTTAGGAAACGTGTAGTCGACGC
AGCTAGGGTCTATTTCTCGGCCGGTGATTT|CTACTACCCATACCCCGTGAATTGAAAGCT
GGAGTAAGGCCTACTACCCGAGGAAACTCT|CGCGATTTTATCTTCAGCAGCCCTGAGCCG
CACGGCCGAGCTCTTTCCTGTCGGACCCTT|CGATGCATCTAGCTCGAATTTTGTAACCCT
ACTACCCGGAAAGAGCTGGAAGAAGTCATG|ACGGAGTAAGGCCTACTACCCCTTCCAGAA
TACCCCGTGAATTGAAAGCTGTTCGGTGGT|CCCGGCTGGTCAGCGCACGGAGTAAGGCCT
AACGTCAGCACATAGCGACAGAAAAGGTTA|ACCAGTATCACTCAGCGCTTCCATCTACGA
CAGGCGCGGGCTCCTAGTCGAGCAGGAAGA|GAGCACAGTTGTTCGGCAGAGGTGGTCCCG
CAGCGCACGGAGTAAGGCCTACTACCCGTC|GTTATGGGTCAGCGCACGGAGTAAGGCCTA
TAGTCCGGGCGAGTGAGACAAACGCGCGCA|AGTAAGGTCAGCGCACGGAGTAAGGCCTAC
ATACCGGTCAGCGCACGGAGTAAGGCCTAC|ACAAGCTTGATTTATAGCTGGTCAGCGCAC
AGTAAGGCCTACTACCCGGCCTACTACCCG|CATGGCTCACCAAAGGTTACGTGCCCATCA
CCATATGTCATGGTCAGCGCACGGAGTAAG|GGTTAGGAAACGTGTAGTCGACGCTATAAT
CGGCCGAGCTCTTTCCTGTCGGACCCTTCT|ATGCATCTAGCTCGAATTTTGTAACCCTGG
GTCATGGCCGACGTTTAACCGAGTGTCCAT|CTACTACCCCACTCCATACTAACCTCAAAG
CAGACGTTATTACACTCGTGACTTGGTTTC|TTTAACCGAGTGTCCATACAGGAGCGCCAC
CTCCAATACCACTGTAGCTTACACACAAGC|CAAACGCTTAAACTCTCCGGTAGAACCCGT
TAAGGCCTACTACCCCACTCCATACTAACC|GGGTCAATCCAGGCGCGGGCTCCTAGTCGA
GGAGTAAGGCCTACTACCCATTCGTTAGGG|TCAAGATAATGCGCCTGTACCAGGTGCACA
TCTTCAGCAGCCCTGAGCCGGTACCACGGC|GCGCACGGAGTAAGGCCTACTACCCGATGC
CCTTCGGTCAGCGCACGGAGTAAGGCCTAC|CTTGATCATCCCACATCGCGATTTTATCTT
CCATGCATGCCTAGACCTCCAATACCACTG|ACTTCAATTGTGATAGCAAACGCTTAAACT
CCATTAGGGTCAGCGCACGGAGTAAGGCCT|CTACCCGTCAGCGCACGGAGTAAGGCCTAC
CCCCTCAAGATAATGCGCCTGTACCAGGTG|TTCGGTCAGCGCACGGAGTAAGGCCTACTA
AGTTGTTCGGCAGAGGTGGTCCCGGGTCAG|GGAGCAAGTTCCGAGTCACACACTTTGGTT
AGGTCAGCGCACGGAGTAAGGCCTACTACC|CCTACTACCCCCTCAAGATAATGCGCCTGT
TACCCCCTCAAGATAATGCGCCTGTACCAG|CCCTTCGGTCAGCGCACGGAGTAAGGCCTA
CGGGCGAGTGAGACAAACGCGCGCAAGAAT|GGTCAGCGCACGGAGTAAGGCCTACTACCC
AGAGAAAGGGATAGCGGTCAGCGCACGGAG|ACTTCTACGGGGGGAGCTAGTGGCTCCATT
GCGCACGGAGTAAGGCCTACTACCCATACC|GTCAGCGCACGGAGTAAGGCCTACTACCCG
GAATTCGGGACGCACGCCATATGTCATGGT|ACCCGGCCTACTACCCGGTTAGGAAACGTG
CGGCAGAGGTGGTCCCGGGTCAGCGCACGG|GTTCCGAGTCACACACTTTGGTTATGGGTC
GAGTAAGGTCAGCGCACGGAGTAAGGCCTA|GGAAAGAGCTGGAAGAAGTCATGGCTCACC
AAGGCCTACTACCCCACTCCATACTAACCT|GGTCAATCCAGGCGCGGGCTCCTAGTCGAG
GCTGTTCGGTGGTCATGGCCGACGTTTAAC|CGGAGTAAGGCCTACTACCCCACTCCATAC
AGGTCGGTCAGCGCACGGAGTAAGGCCTAC|TGTCATTAGGGTCAGCGCACGGAGTAAGGC
AGCGCACGGAGTAAGGCCTACTACCCCACT|CCATTCGTTAGGGGTCAATCCAGGCGCGGG
CAGTTGTTCGGCAGAGGTGGTCCCGGGTCA|AGGAGCAAGTTCCGAGTCACACACTTTGGT
GCCTACTACCCGGCTGGTCAGCGCACGGAG|ACGGAGTAAGGCCTACTACCCATTCGTTAG
GTAAGGCCTACTACCCATACCCCGTGAATT|CGGAGTAAGGCCTACTACCCGGCTGGTCAG
GGAGCTAGTGGCTCCATTAGGGTCAGCGCA|GGAGTAAGGCCTACTACCCGTCAGCGCACG
CTGTACCAGGTGCACATATGGAAGAGCACA|TAAGGCCTACTACCCGAGGAAACTCTCGAG
GCCTACTACCCGGAAAGAGCTGGAAGAAGT|GCGCACGGAGTAAGGCCTACTACCCCTTCC
GTAGTCGACGCTATAATACCGCAGGTACTG|ATGCCTAGACCTCCAATACCACTGTAGCTT
GGTGGTCATGGCCGACGTTTAACCGAGTGT|AGGCCTACTACCCCACTCCATACTAACCTC
CGGGATGCTATGACGGTGTCTATGTCATTA|AGCGGTCAGCGCACGGAGTAAGGCCTACTA
GAAACGTCAGCACATAGCGACAGAAAAGGT|TCACCAGTATCACTCAGCGCTTCCATCTAC
ACTACCCATACCCCGTGAATTGAAAGCTGT|GCCTACTACCCGGCTGGTCAGCGCACGGAG
TCACACCATGCATGCCTAGACCTCCAATAC|TACCTACTTCAATTGTGATAGCAAACGCTT
GCGCACGGAGTAAGGCCTACTACCCGGCCT|GAAGAAGTCATGGCTCACCAAAGGTTACGT
CCATACCCCGTGAATTGAAAGCTGTTCGGT|CTACCCGGCTGGTCAGCGCACGGAGTAAGG
GCCATATGTCATGGTCAGCGCACGGAGTAA|CGGTTAGGAAACGTGTAGTCGACGCTATAA
TGGCTCCATTAGGGTCAGCGCACGGAGTAA|GCCTACTACCCGTCAGCGCACGGAGTAAGG
GGAGCGCCACGCGGGATGCTATGACGGTGT|GAGAAAGGGATAGCGGTCAGCGCACGGAGT
TACTACCCGCTGGGGAGGTCAGCGCACGGA|GCGCACGGAGTAAGGCCTACTACCCCCTCA
AGGTACTGTGTGATACCGGTCAGCGCACGG|TGTAGCTTACACACAAGCTTGATTTATAGC
CTACTACCCCACTCCATACTAACCTCAAAG|ATCCAGGCGCGGGCTCCTAGTCGAGCAGGA
CGGCTGGTCAGCGCACGGAGTAAGGCCTAC|GCCTACTACCCATTCGTTAGGGGTCAATCC
TGGTCATGGCCGACGTTTAACCGAGTGTCC|GCCTACTACCCCACTCCATACTAACCTCAA
TTTGGTTATGGGTCAGCGCACGGAGTAAGG|GGACCCTTCTAAAGCGGCTGATAGTCCGGG
GCACGGAGTAAGGCCTACTACCCCACTCCA|TTCGTTAGGGGTCAATCCAGGCGCGGGCTC
CACTGTAGCTTACACACAAGCTTGATTTAT|AAACTCTCCGGTAGAACCCGTCCTTTATGT
TAGCGGTCAGCGCACGGAGTAAGGCCTACT|GGGAGCTAGTGGCTCCATTAGGGTCAGCGC
CACGGAGTAAGGCCTACTACCCATTCGTTA|CCCTCAAGATAATGCGCCTGTACCAGGTGC
GTGCCCATCAGTCACACCATGCATGCCTAG|ACAGAAAAGGTTACCTACTTCAATTGTGAT
TGGCTCACCAAAGGTTACGTGCCCATCAGT|AAACGTCAGCACATAGCGACAGAAAAGGTT
ACTACCCGGCCTACTACCCGGTTAGGAAAC|CAAAGGTTACGTGCCCATCAGTCACACCAT
CGCGATTTTATCTTCAGCAGCCCTGAGCCG|GTCATGGTCAGCGCACGGAGTAAGGCCTAC
CAAGAATTCGGGACGCACGCCATATGTCAT|ACTACCCGGCCTACTACCCGGTTAGGAAAC
GAGTAAGGCCTACTACCCATACCCCGTGAA|CACGGAGTAAGGCCTACTACCCGGCTGGTC
GTGGTCCCGGGTCAGCGCACGGAGTAAGGC|TCACACACTTTGGTTATGGGTCAGCGCACG
GGGTCAGCGCACGGAGTAAGGCCTACTACC|TTTGGTTATGGGTCAGCGCACGGAGTAAGG
GAGCTCTTTCCTGTCGGACCCTTCTAAAGC|TCTAGCTCGAATTTTGTAACCCTGGTCAGC
CAGTCACACCATGCATGCCTAGACCTCCAA|GGTTACCTACTTCAATTGTGATAGCAAACG
CACGGAGTAAGGCCTACTACCCCACTCCAT|TCGTTAGGGGTCAATCCAGGCGCGGGCTCC
CGTTATTACACTCGTGACTTGGTTTCTCAT|ACCGAGTGTCCATACAGGAGCGCCACGCGG
TTCCTGTCGGACCCTTCTAAAGCGGCTGAT|CGAATTTTGTAACCCTGGTCAGCGCACGGA
GGGAGCTAGTGGCTCCATTAGGGTCAGCGC|CGGAGTAAGGCCTACTACCCGTCAGCGCAC
TTAGGGGTCAATCCAGGCGCGGGCTCCTAG|TGCACATATGGAAGAGCACAGTTGTTCGGC
GGTCAGCGCACGGAGTAAGGCCTACTACCC|CAAACATATCGTCGTACGAGATAATCACGC
CCTACTACCCGGCCTACTACCCGGTTAGGA|CACCAAAGGTTACGTGCCCATCAGTCACAC
GAAAGCTGTTCGGTGGTCATGGCCGACGTT|CGCACGGAGTAAGGCCTACTACCCCACTCC
CTACTACCCTTCGGTCAGCGCACGGAGTAA|CCGAACACTTGATCATCCCACATCGCGATT
TCTATTTCTCGGCCGGTGATTTTCTTAGGG|CATACCCCGTGAATTGAAAGCTGTTCGGTG
GAAGAGAAAGGGATAGCGGTCAGCGCACGG|AGACTTCTACGGGGGGAGCTAGTGGCTCCA
TCTCGAGGAGCAAGTTCCGAGTCACACACT|CCGGTACCACGGCCGAGCTCTTTCCTGTCG
TGAATTGAAAGCTGTTCGGTGGTCATGGCC|GGTCAGCGCACGGAGTAAGGCCTACTACCC
TCTAAAGCGGCTGATAGTCCGGGCGAGTGA|TGGTCAGCGCACGGAGTAAGGTCAGCGCAC
CCGAACACTTGATCATCCCACATCGCGATT|AGAATTCGGGACGCACGCCATATGTCATGG
TCGGACCCTTCTAAAGCGGCTGATAGTCCG|TTGTAACCCTGGTCAGCGCACGGAGTAAGG
CTACCCGTCAGCGCACGGAGTAAGGCCTAC|TAAGGCCTACTACCCGAAATGCCCTACCGA
TATTCAAAGGTACGGAAGGTCGGTCAGCGC|GCTATGACGGTGTCTATGTCATTAGGGTCA
TGTCTATGTCATTAGGGTCAGCGCACGGAG|AGTAAGGCCTACTACCCGCTGGGGAGGTCA
CTACGGGGGGAGCTAGTGGCTCCATTAGGG|CAGCGCACGGAGTAAGGCCTACTACCCGTC
TTGGTTATGGGTCAGCGCACGGAGTAAGGC|GACCCTTCTAAAGCGGCTGATAGTCCGGGC
GTGATACCGGTCAGCGCACGGAGTAAGGCC|CACACAAGCTTGATTTATAGCTGGTCAGCG
CCCACATCGCGATTTTATCTTCAGCAGCCC|GCCATATGTCATGGTCAGCGCACGGAGTAA
CTACTACCCGTCAGCGCACGGAGTAAGGCC|GAGTAAGGCCTACTACCCGAAATGCCCTAC
CGCTGGGGAGGTCAGCGCACGGAGTAAGGC|GAGTAAGGCCTACTACCCCCTCAAGATAAT
TCAGCGCACGGAGTAAGGCCTACTACCCCC|AGCGCACGGAGTAAGGCCTACTACCCTTCG
CACTCCATACTAACCTCAAAGGAAGAGAAA|CGGGCTCCTAGTCGAGCAGGAAGACTTCTA
GGAGTAAGGCCTACTACCCGGCTGGTCAGC|GTCAGCGCACGGAGTAAGGCCTACTACCCA
CACAGTTGTTCGGCAGAGGTGGTCCCGGGT|CGAGGAGCAAGTTCCGAGTCACACACTTTG
GGTACCACGGCCGAGCTCTTTCCTGTCGGA|CTACCCGATGCATCTAGCTCGAATTTTGTA
ACGGAGTAAGGCCTACTACCCCACTCCATA|CGTTAGGGGTCAATCCAGGCGCGGGCTCCT
GGTTTCTCATCCCTATTCAAAGGTACGGAA|CGCCACGCGGGATGCTATGACGGTGTCTAT
GCCCTGAGCCGGTACCACGGCCGAGCTCTT|GTAAGGCCTACTACCCGATGCATCTAGCTC
CTGGTCAGCGCACGGAGTAAGGTCAGCGCA|AAGGCCTACTACCCGGAAAGAGCTGGAAGA
TACGTGCCCATCAGTCACACCATGCATGCC|GCGACAGAAAAGGTTACCTACTTCAATTGT
TCTCATCCCTATTCAAAGGTACGGAAGGTC|ACGCGGGATGCTATGACGGTGTCTATGTCA
AGGGTCAGCGCACGGAGTAAGGCCTACTAC|ACCCGCTGGGGAGGTCAGCGCACGGAGTAA
TATGTCATTAGGGTCAGCGCACGGAGTAAG|AGGCCTACTACCCGCTGGGGAGGTCAGCGC
CAGCAGCCCTGAGCCGGTACCACGGCCGAG|ACGGAGTAAGGCCTACTACCCGATGCATCT
ACCTCAAAGGAAGAGAAAGGGATAGCGGTC|CGAGCAGGAAGACTTCTACGGGGGGAGCTA
CCATTCGTTAGGGGTCAATCCAGGCGCGGG|TACCAGGTGCACATATGGAAGAGCACAGTT
CTATGACGGTGTCTATGTCATTAGGGTCAG|AGCGCACGGAGTAAGGCCTACTACCCGCTG
CATGGTCAGCGCACGGAGTAAGGCCTACTA|AACGTGTAGTCGACGCTATAATACCGCAGG
TCCAGGCGCGGGCTCCTAGTCGAGCAGGAA|AAGAGCACAGTTGTTCGGCAGAGGTGGTCC
TAAGGCCTACTACCCCCTCAAGATAATGCG|AGGCCTACTACCCTTCGGTCAGCGCACGGA
ATTTTATCTTCAGCAGCCCTGAGCCGGTAC|TGGTCAGCGCACGGAGTAAGGCCTACTACC
CCTAGACCTCCAATACCACTGTAGCTTACA|GTGATAGCAAACGCTTAAACTCTCCGGTAG
GACGCTATAATACCGCAGGTACTGTGTGAT|AGACCTCCAATACCACTGTAGCTTACACAC
ATTACACTCGTGACTTGGTTTCTCATCCCT|AGTGTCCATACAGGAGCGCCACGCGGGATG
CTCGAATTTTGTAACCCTGGTCAGCGCACG|GGTCAGCGCACGGAGTAAGGCCTACTACCC
CTACTACCCCCTCAAGATAATGCGCCTGTA|ACTACCCTTCGGTCAGCGCACGGAGTAAGG
CAATACCACTGTAGCTTACACACAAGCTTG|ACGCTTAAACTCTCCGGTAGAACCCGTCCT
TACTACCCGAAATGCCCTACCGAACACTTG|AGTGAGACAAACGCGCGCAAGAATTCGGGA
TTTCTCATCCCTATTCAAAGGTACGGAAGG|CCACGCGGGATGCTATGACGGTGTCTATGT
CACGGAGTAAGGTCAGCGCACGGAGTAAGG|ACCCGGAAAGAGCTGGAAGAAGTCATGGCT
GAAAGGGATAGCGGTCAGCGCACGGAGTAA|TCTACGGGGGGAGCTAGTGGCTCCATTAGG
GCGCGGGCTCCTAGTCGAGCAGGAAGACTT|CACAGTTGTTCGGCAGAGGTGGTCCCGGGT
AGCTGTTCGGTGGTCATGGCCGACGTTTAA|ACGGAGTAAGGCCTACTACCCCACTCCATA
CCTATTCAAAGGTACGGAAGGTCGGTCAGC|ATGCTATGACGGTGTCTATGTCATTAGGGT
CTGGAAGAAGTCATGGCTCACCAAAGGTTA|CTACCCCTTCCAGAAACGTCAGCACATAGC
TCAGCGCACGGAGTAAGGCCTACTACCCAT|AGGGTCAGCGCACGGAGTAAGGCCTACTAC
GCGGGCTCCTAGTCGAGCAGGAAGACTTCT|CAGTTGTTCGGCAGAGGTGGTCCCGGGTCA
GCACGGAGTAAGGCCTACTACCCGTCAGCG|TGGGTCAGCGCACGGAGTAAGGCCTACTAC
ACATATGGAAGAGCACAGTTGTTCGGCAGA|CCGAGGAAACTCTCGAGGAGCAAGTTCCGA
TAGCTGGTCAGCGCACGGAGTAAGGCCTAC|TACAGCAAACATATCGTCGTACGAGATAAT
CTACTACCCCTTCCAGAAACGTCAGCACAT|TAATCACGCAATTGTTCACCAGTATCACTC
GATACCGGTCAGCGCACGGAGTAAGGCCTA|CACAAGCTTGATTTATAGCTGGTCAGCGCA
GCCTACTACCCCTTCCAGAAACGTCAGCAC|GATAATCACGCAATTGTTCACCAGTATCAC
ACCACGGCCGAGCTCTTTCCTGTCGGACCC|CCCGATGCATCTAGCTCGAATTTTGTAACC
TACTACCCGGTTAGGAAACGTGTAGTCGAC|TGCCCATCAGTCACACCATGCATGCCTAGA
TACGGAAGGTCGGTCAGCGCACGGAGTAAG|TGTCTATGTCATTAGGGTCAGCGCACGGAG
ATGACGGTGTCTATGTCATTAGGGTCAGCG|CGCACGGAGTAAGGCCTACTACCCGCTGGG
GCTTGATTTATAGCTGGTCAGCGCACGGAG|GTCCTTTATGTACAGCAAACATATCGTCGT
GAGCGCCACGCGGGATGCTATGACGGTGTC|AGAAAGGGATAGCGGTCAGCGCACGGAGTA
CACACAAGCTTGATTTATAGCTGGTCAGCG|AGAACCCGTCCTTTATGTACAGCAAACATA
GTTATTACACTCGTGACTTGGTTTCTCATC|CCGAGTGTCCATACAGGAGCGCCACGCGGG
GCTCACCAAAGGTTACGTGCCCATCAGTCA|ACGTCAGCACATAGCGACAGAAAAGGTTAC
CAATCCAGGCGCGGGCTCCTAGTCGAGCAG|TGGAAGAGCACAGTTGTTCGGCAGAGGTGG
GCCGGTGATTTTCTTAGGGACGGATTGATT|AATTGAAAGCTGTTCGGTGGTCATGGCCGA
TTATTACACTCGTGACTTGGTTTCTCATCC|CGAGTGTCCATACAGGAGCGCCACGCGGGA
CGATTTTATCTTCAGCAGCCCTGAGCCGGT|CATGGTCAGCGCACGGAGTAAGGCCTACTA
GGTACTGTGTGATACCGGTCAGCGCACGGA|GTAGCTTACACACAAGCTTGATTTATAGCT
ACGGAGTAAGGCCTACTACCCCTTCCAGAA|CGTCGTACGAGATAATCACGCAATTGTTCA
CCGAGGAAACTCTCGAGGAGCAAGTTCCGA|CAGCCCTGAGCCGGTACCACGGCCGAGCTC
GTGAATTGAAAGCTGTTCGGTGGTCATGGC|TGGTCAGCGCACGGAGTAAGGCCTACTACC
CGCACGGAGTAAGGCCTACTACCCGAGGAA|CACATCGCGATTTTATCTTCAGCAGCCCTG
GGCCTACTACCCGATGCATCTAGCTCGAAT|TACCGCAGGTACTGTGTGATACCGGTCAGC
CACGCGGGATGCTATGACGGTGTCTATGTC|GGATAGCGGTCAGCGCACGGAGTAAGGCCT
CACACCATGCATGCCTAGACCTCCAATACC|ACCTACTTCAATTGTGATAGCAAACGCTTA
GCCTACTACCCCCTCAAGATAATGCGCCTG|CTACTACCCTTCGGTCAGCGCACGGAGTAA
GGTCAGCGCACGGAGTAAGGCCTACTACCC|CTACCCATTCGTTAGGGGTCAATCCAGGCG
CGGAGTAAGGCCTACTACCCGGCTGGTCAG|GGTCAGCGCACGGAGTAAGGCCTACTACCC
